1 0 0 0 2 -1 -1 3 0 0 0 -1 0 0 0 0 5 0 0 4 0 6 0 0 -1 0 7 0 0 0 8 0 0 0 0 0 
0 0 6 0 7 0 0 0 -1 0 0 0 -1 0 2 0 -1 8 -1 0 0 0 0 1 5 0 0 0 3 0 0 0 0 4 0 0 
0 0 0 0 0 1 0 -1 -1 8 0 0 0 2 0 0 0 7 4 0 0 0 3 0 0 -1 0 0 -1 0 0 0 5 0 6 0 
8 0 0 -1 0 6 1 0 7 0 0 0 -1 0 0 0 -1 0 2 0 0 0 5 0 0 0 0 0 0 0 -1 0 3 0 4 0 
0 0 0 3 0 0 2 0 0 0 1 0 0 0 0 0 0 4 6 -1 5 0 -1 -1 0 7 0 0 0 0 0 0 0 0 -1 8 
0 0 0 1 0 7 2 -1 0 0 0 0 0 -1 0 6 0 0 0 -1 5 0 0 8 0 0 0 -1 0 4 0 0 3 0 0 0 
-1 8 0 0 7 0 0 0 0 0 0 0 0 0 1 0 2 0 0 0 -1 0 -1 6 4 0 3 0 -1 0 0 0 0 5 0 0 
0 0 3 -1 0 0 0 0 0 -1 0 0 4 0 2 0 0 0 0 0 0 -1 -1 1 0 0 5 8 0 0 0 6 0 0 0 7 
0 0 7 0 0 8 0 6 0 0 0 -1 5 0 0 0 0 -1 0 -1 0 0 0 1 0 0 2 0 0 0 -1 4 0 0 0 3 
0 0 0 0 0 0 2 0 0 0 3 0 0 0 0 1 -1 4 0 0 5 0 0 0 0 0 0 7 0 -1 6 0 -1 8 0 -1 
0 0 7 0 0 -1 8 -1 0 1 0 0 -1 0 0 0 3 0 -1 2 0 0 0 0 0 0 4 0 0 0 0 5 0 0 0 6 
8 -1 0 0 0 4 0 0 5 0 0 0 -1 7 0 -1 0 0 0 0 0 0 6 0 0 0 0 2 -1 3 0 0 1 0 0 0 
0 1 -1 0 0 -1 0 0 2 0 3 0 0 5 -1 4 0 0 0 0 0 0 -1 8 0 0 0 0 0 0 0 0 6 0 7 0 
0 0 0 0 5 0 0 6 -1 0 0 0 0 0 2 0 -1 0 0 0 0 0 -1 4 7 0 1 0 3 0 0 0 8 -1 0 0 
0 0 0 1 0 5 2 0 -1 0 0 0 0 0 0 4 0 0 3 0 0 -1 6 0 0 0 8 -1 -1 0 0 0 0 0 7 0 
0 0 -1 3 0 0 5 0 4 0 2 0 0 0 0 0 0 -1 6 0 -1 -1 0 0 0 1 0 0 0 0 0 0 7 0 0 8 
0 0 1 0 0 0 0 0 0 7 -1 2 0 -1 0 0 0 0 8 -1 0 -1 0 3 0 0 6 0 4 0 0 5 0 0 0 0 
0 0 2 0 0 -1 0 3 0 0 0 1 7 0 0 0 4 0 0 -1 0 0 0 0 0 -1 6 0 0 0 8 -1 0 0 0 5 
8 0 0 7 0 0 5 0 0 0 6 0 0 0 0 4 0 0 0 0 0 0 -1 0 0 -1 -1 2 -1 3 0 0 1 0 0 0 
8 0 0 -1 0 0 -1 0 7 -1 4 0 0 0 -1 0 0 3 6 0 0 0 0 0 0 1 0 5 0 0 0 0 2 0 0 0 
0 0 3 0 -1 8 0 2 0 0 0 0 4 0 0 -1 0 0 0 0 0 1 -1 0 5 0 6 0 -1 0 0 0 0 0 0 7 
0 5 0 0 0 4 0 0 0 0 0 0 0 2 0 3 0 -1 0 0 0 0 1 8 -1 0 0 0 0 0 -1 0 6 -1 7 0 
0 0 -1 0 0 0 0 6 0 5 -1 4 7 0 0 0 0 0 0 0 0 0 0 1 0 0 3 0 0 0 8 -1 -1 0 0 2 
0 0 1 0 5 0 0 3 0 0 0 0 2 0 0 0 4 0 0 0 -1 -1 -1 6 -1 0 0 0 7 0 8 0 0 0 0 0 
-1 -1 0 0 0 0 0 4 0 5 0 6 0 0 3 0 0 0 0 0 0 0 0 0 2 0 0 8 0 0 -1 1 0 -1 0 7 
8 -1 0 0 0 2 0 -1 0 0 0 0 0 5 0 1 0 0 7 0 0 0 4 0 0 0 0 -1 0 3 0 0 6 -1 0 0 
0 0 0 0 0 6 4 -1 5 0 0 0 0 0 0 0 0 -1 0 0 3 0 7 -1 0 0 0 1 0 0 2 0 0 0 -1 8 
0 7 0 0 8 -1 0 0 6 0 0 0 -1 -1 0 1 -1 5 2 0 0 0 0 0 0 3 0 0 0 0 0 0 0 0 4 0 
0 6 0 0 0 7 0 0 5 8 0 0 0 1 0 0 -1 -1 0 0 -1 0 0 0 0 2 0 0 -1 0 0 0 3 0 4 0 
2 0 0 0 0 -1 0 0 0 1 0 -1 5 0 -1 0 0 8 0 0 -1 3 0 0 0 0 4 0 0 0 0 6 0 0 0 7 
-1 -1 0 0 0 0 0 0 2 0 3 0 0 1 0 5 -1 4 6 0 0 0 0 0 0 -1 8 0 0 7 0 0 0 0 0 0 
0 0 0 0 0 3 0 0 -1 0 0 0 -1 2 0 4 0 0 1 0 0 -1 5 0 0 0 8 -1 0 0 7 0 0 0 6 0 
-1 8 -1 0 0 0 0 0 0 6 0 5 7 0 0 -1 0 0 0 0 0 0 0 4 0 -1 0 0 2 0 0 1 0 3 0 0 
7 0 -1 0 5 0 0 0 -1 0 -1 0 0 0 6 0 4 0 0 0 0 2 0 0 0 0 1 0 0 0 0 0 8 -1 0 3 
0 0 0 0 0 5 3 0 4 0 0 0 -1 0 0 2 0 -1 0 0 0 0 6 0 0 -1 -1 7 0 0 0 0 1 0 0 8 
-1 -1 0 0 5 -1 0 2 0 4 0 0 0 0 0 0 0 0 0 1 0 3 0 6 0 8 -1 0 0 0 0 7 0 0 0 0 
2 0 0 0 -1 8 0 0 0 1 -1 0 0 0 3 0 -1 0 0 4 0 0 -1 7 5 0 0 0 6 0 0 0 0 0 0 0 
0 0 6 0 0 -1 0 -1 0 0 0 0 5 0 0 0 2 0 0 3 -1 0 0 7 0 0 0 0 1 0 0 4 0 -1 8 0 
0 0 0 3 0 0 2 -1 0 0 4 0 0 -1 0 0 -1 -1 0 0 1 0 0 0 0 6 0 0 0 5 0 0 7 0 0 8 
0 1 0 0 0 -1 0 0 2 -1 3 -1 0 0 0 0 0 0 0 0 5 0 4 0 0 0 0 7 0 0 6 0 0 0 -1 8 
1 0 0 -1 0 0 8 -1 0 2 0 3 0 -1 4 0 0 0 0 0 0 -1 0 6 7 0 5 0 0 0 0 0 0 0 0 0 
0 2 0 0 8 0 0 0 -1 0 1 0 0 0 0 0 0 7 0 0 3 0 4 0 -1 5 0 0 0 0 -1 0 0 0 6 -1 
-1 0 6 0 7 -1 0 0 0 0 0 0 5 0 0 0 0 8 0 0 0 1 0 0 2 0 3 0 4 0 0 0 0 0 -1 -1 
0 3 0 1 0 0 0 -1 0 0 2 0 0 6 0 0 0 0 4 0 0 0 7 0 0 0 0 -1 0 -1 0 0 5 -1 0 8 
0 0 -1 -1 0 1 0 0 2 0 0 8 0 0 0 3 0 0 -1 0 4 0 0 0 0 0 0 6 0 7 5 0 0 0 0 -1 
0 0 0 1 0 0 2 0 -1 0 5 0 0 0 -1 0 0 6 3 0 0 0 4 0 8 0 -1 0 0 0 -1 0 0 0 7 0 
2 0 0 0 1 8 0 0 0 0 0 0 -1 0 3 -1 4 0 0 0 -1 0 0 0 6 0 5 0 0 0 0 0 0 7 0 -1 
0 0 2 0 0 0 0 3 0 7 0 1 -1 -1 0 0 0 8 0 4 0 0 0 -1 0 0 0 0 6 0 -1 5 0 0 0 0 
0 6 0 7 0 0 0 0 0 -1 -1 8 0 0 0 3 0 0 5 0 4 -1 -1 0 0 0 0 2 0 0 1 0 0 0 0 0 
0 0 1 8 0 0 0 2 0 0 0 0 -1 0 0 0 3 0 -1 4 -1 6 0 0 0 0 0 0 0 0 0 5 0 -1 0 7 
0 0 2 0 1 -1 0 -1 0 0 0 0 3 0 4 0 5 0 0 0 0 0 -1 6 -1 0 0 0 7 0 8 0 0 0 0 0 
0 0 6 0 -1 8 0 1 0 0 0 0 5 0 0 0 7 0 -1 0 0 0 0 0 0 0 4 -1 -1 0 0 3 0 0 0 2 
0 0 5 0 0 0 0 4 0 -1 -1 0 3 0 0 0 0 0 0 0 0 6 0 0 0 0 2 -1 7 0 0 1 8 0 0 -1 
0 0 1 0 3 0 0 2 0 0 -1 0 0 0 0 0 4 0 0 0 -1 0 0 6 -1 0 5 0 -1 0 8 0 0 7 0 0 
5 0 6 0 -1 8 0 0 0 0 0 0 0 0 0 0 7 0 0 4 0 3 -1 -1 1 -1 0 0 2 0 0 0 0 0 0 0 
0 0 6 0 -1 8 0 0 0 0 0 0 0 0 5 0 7 -1 -1 -1 0 0 0 1 4 0 0 0 2 0 0 0 0 3 0 0 
0 0 5 -1 0 0 0 4 0 0 0 6 -1 0 0 0 0 0 -1 0 0 3 0 7 2 0 0 0 -1 0 0 0 0 1 8 0 
0 0 1 -1 0 8 0 2 -1 0 0 -1 -1 0 0 0 0 0 0 3 0 0 0 7 0 0 0 0 6 0 0 4 0 5 0 0 
-1 0 5 0 6 0 0 0 0 0 0 0 4 0 3 0 7 -1 0 0 0 0 0 0 0 0 2 0 0 0 0 1 8 0 -1 -1 
-1 -1 0 0 2 0 0 3 0 0 0 0 0 0 4 0 0 0 0 0 0 -1 -1 1 5 0 0 0 6 0 8 0 0 7 0 0 
0 5 0 -1 8 0 0 0 0 -1 7 0 -1 4 0 0 0 -1 0 0 6 0 0 0 0 3 0 0 0 0 1 0 0 0 2 0 
0 0 0 0 -1 -1 5 0 0 0 6 0 0 4 0 0 -1 0 0 0 -1 0 3 0 0 2 0 0 0 7 0 0 1 8 0 0 
0 0 7 0 0 0 8 -1 0 0 0 6 1 0 0 -1 0 0 0 0 0 5 -1 -1 2 0 3 0 0 0 0 0 0 0 0 4 
0 0 0 3 0 0 2 0 0 0 1 0 0 0 0 7 -1 4 0 -1 0 0 0 0 0 0 8 -1 0 5 -1 0 6 0 0 0 
1 0 0 0 0 0 8 0 0 0 -1 0 -1 0 3 0 2 0 0 7 0 0 0 4 0 0 0 0 -1 0 -1 6 0 5 0 0 
0 0 6 0 0 0 0 -1 8 0 0 7 5 0 1 0 -1 -1 0 0 0 0 0 2 4 0 0 0 0 0 -1 0 0 3 0 0 
0 0 0 1 0 0 2 0 0 0 3 0 0 4 0 0 0 0 0 0 6 0 7 -1 0 0 0 0 0 0 5 0 -1 -1 -1 8 
2 0 3 0 0 -1 0 0 0 -1 0 4 0 0 1 0 0 0 -1 7 0 0 0 0 0 0 0 0 0 0 8 -1 0 6 0 5 
0 0 1 0 3 0 0 2 0 0 -1 0 5 0 4 0 -1 0 0 0 0 0 0 0 0 -1 0 0 0 8 0 6 0 7 0 -1 
0 0 1 0 0 8 0 0 0 7 0 0 2 0 3 0 6 0 -1 0 0 0 0 -1 0 0 0 0 0 -1 0 4 0 5 0 -1 
0 0 0 1 0 0 2 0 0 0 3 0 0 0 0 0 0 4 0 -1 -1 -1 6 0 0 5 0 0 0 0 -1 8 0 0 7 0 
0 0 6 0 0 0 0 5 -1 -1 0 7 0 0 0 0 0 8 0 4 0 3 0 -1 0 0 1 0 0 0 0 0 -1 0 0 2 
0 0 0 0 0 5 3 -1 4 0 0 0 0 0 0 2 0 6 0 0 1 0 -1 0 0 0 0 0 0 0 -1 8 0 0 7 -1 
0 0 0 0 -1 -1 5 0 0 0 6 -1 0 0 0 4 0 0 3 0 0 0 7 0 0 2 0 0 0 0 0 0 1 0 -1 8 
-1 2 0 0 0 1 0 0 4 0 0 0 0 3 0 0 0 5 -1 0 0 0 0 0 8 -1 0 0 0 0 0 0 7 0 6 -1 
-1 -1 2 0 -1 8 0 0 0 0 -1 0 3 0 0 0 1 0 0 4 0 0 0 0 0 0 0 0 7 0 0 5 0 6 0 0 
0 0 0 0 0 0 2 0 3 0 4 0 0 0 -1 -1 -1 5 1 0 0 0 -1 0 0 6 0 0 0 0 0 0 7 0 0 8 
-1 0 0 0 0 -1 2 0 3 0 4 0 0 0 0 1 0 0 0 0 -1 0 0 8 0 5 0 0 0 0 6 0 0 0 7 -1 
0 0 1 8 0 0 0 0 -1 0 0 7 0 0 6 0 -1 -1 0 -1 0 0 0 0 2 0 3 0 5 0 0 0 0 0 0 4 
0 0 0 -1 0 0 3 0 4 0 5 0 0 0 0 0 -1 6 0 0 0 0 0 0 0 2 0 7 0 0 -1 -1 0 0 1 8 
2 0 -1 -1 4 0 0 0 0 0 0 0 0 0 3 0 5 0 0 1 -1 0 0 0 -1 0 7 0 6 0 8 0 0 0 0 0 
1 -1 0 0 -1 8 0 0 0 0 0 0 -1 0 0 0 2 0 0 3 0 0 0 7 0 -1 6 0 0 0 0 4 0 0 0 5 
0 0 0 0 0 6 0 0 5 0 -1 0 0 4 0 0 -1 0 0 0 -1 -1 7 0 0 3 0 0 0 0 0 0 2 0 1 8 
8 0 0 -1 0 0 -1 -1 7 0 0 0 0 5 0 6 0 0 0 0 0 0 3 0 0 4 0 0 0 0 1 0 0 0 2 -1 
-1 0 0 0 3 0 0 0 0 0 0 0 2 0 0 -1 4 0 0 7 0 1 0 0 0 0 0 -1 5 0 8 -1 0 6 0 0 
5 0 6 0 7 0 0 0 0 0 0 0 0 0 4 0 0 8 0 2 0 -1 0 0 0 -1 0 0 0 0 0 1 0 3 -1 -1 
4 0 -1 -1 0 0 0 0 0 3 0 2 0 0 0 0 0 0 -1 5 0 0 0 1 0 0 0 0 0 8 0 6 0 7 0 -1 
5 0 6 0 7 0 0 0 0 0 0 0 0 0 4 0 0 8 -1 0 0 1 0 3 2 0 -1 0 0 0 0 0 0 0 -1 -1 
0 0 0 0 0 5 3 0 4 -1 0 0 0 0 0 2 0 6 1 0 0 0 0 0 0 0 -1 7 0 -1 0 0 -1 0 0 8 
0 0 0 -1 0 2 0 -1 0 -1 0 0 0 4 0 3 0 0 5 0 0 0 1 0 0 6 0 7 0 -1 0 0 0 0 0 8 
8 -1 0 2 0 0 0 -1 0 0 1 0 0 0 0 6 -1 3 7 0 0 0 -1 0 0 0 0 0 0 0 0 0 5 0 4 0 
0 0 0 2 0 0 1 0 4 -1 0 0 0 0 0 0 0 0 5 0 -1 0 3 0 0 0 0 7 0 -1 6 0 0 -1 0 8 
2 0 0 0 1 8 0 0 0 3 0 0 -1 -1 0 0 0 0 0 5 0 4 0 7 0 0 0 -1 0 0 0 0 0 6 0 -1 
0 0 7 0 0 8 0 0 0 0 0 6 -1 -1 1 0 -1 0 0 2 0 0 0 0 0 0 0 -1 5 0 0 3 0 4 0 0 
0 1 0 0 0 3 0 0 2 -1 -1 0 0 0 0 4 0 0 5 0 -1 0 7 0 0 0 8 0 0 0 6 0 0 0 0 -1 
0 0 0 -1 0 0 0 0 4 -1 1 0 0 0 0 3 -1 2 0 0 6 0 0 0 0 0 0 0 0 7 5 0 -1 8 0 0 
0 0 0 2 0 0 3 0 0 -1 1 0 0 4 0 6 0 0 0 0 0 0 -1 0 0 5 0 -1 0 7 0 0 0 -1 0 8 
0 0 0 0 0 0 0 0 -1 5 0 6 4 0 3 0 0 0 0 0 0 2 0 0 1 0 0 0 7 0 -1 -1 8 0 0 -1 
4 0 0 0 -1 8 0 -1 0 5 0 0 0 0 0 0 7 0 0 3 -1 6 0 0 0 0 0 0 1 0 0 2 -1 0 0 0 
3 0 0 -1 0 0 0 0 0 2 0 1 4 0 5 0 0 0 0 0 0 0 0 0 0 0 7 0 6 -1 8 -1 0 0 0 -1 
0 0 3 0 1 0 0 2 0 0 -1 0 4 0 0 0 0 0 0 0 0 0 -1 -1 5 0 6 0 7 0 0 0 0 -1 8 0 
0 4 0 3 0 2 0 0 0 0 0 0 0 0 0 0 0 0 5 0 1 -1 -1 -1 0 6 0 7 0 0 0 0 0 0 -1 8 
3 0 4 0 0 -1 0 0 0 -1 0 5 0 0 2 0 0 0 -1 0 0 0 0 0 -1 0 1 0 0 0 8 0 0 7 0 6 
3 0 0 0 4 -1 0 0 0 2 0 0 1 0 0 0 5 0 0 0 0 0 0 0 7 0 -1 0 6 0 8 0 -1 0 0 -1 
-1 0 0 5 0 0 4 0 0 0 6 0 0 -1 0 0 0 0 0 0 0 0 7 0 0 3 -1 2 0 -1 1 0 0 0 0 8 
-1 6 0 0 0 7 0 0 -1 8 0 0 0 -1 0 0 0 1 5 0 2 0 0 0 0 0 0 0 -1 3 0 0 4 0 0 0 
0 0 0 1 8 0 2 -1 -1 0 0 0 0 0 0 0 0 -1 0 0 3 -1 7 0 0 0 0 0 0 0 4 0 5 0 6 0 
-1 5 0 -1 0 7 0 0 0 0 0 0 0 0 0 6 0 0 4 0 3 0 -1 8 0 0 0 0 0 0 1 -1 2 0 0 0 
8 -1 0 5 0 0 0 0 0 0 4 0 0 6 0 0 0 -1 7 0 0 -1 3 0 0 1 0 0 -1 0 0 0 0 0 2 0 
0 0 0 1 8 0 2 0 0 0 -1 0 0 0 0 3 0 7 4 0 0 0 0 -1 0 0 -1 5 0 6 0 0 -1 0 0 0 
0 0 6 0 0 0 0 7 0 0 0 5 -1 0 0 0 0 0 8 0 0 3 0 4 -1 0 0 -1 0 0 -1 2 0 0 0 1 
0 0 0 0 0 3 0 0 4 0 0 0 -1 -1 -1 0 0 2 0 0 5 0 0 0 0 0 0 1 0 -1 6 0 7 0 0 8 
0 0 2 0 0 0 0 -1 8 -1 0 3 1 -1 0 0 0 0 0 7 -1 0 0 4 0 0 0 0 0 0 0 6 0 0 0 5 
0 0 6 0 0 0 0 4 0 0 0 5 0 0 0 0 0 0 0 -1 0 3 0 2 0 -1 1 0 0 -1 0 7 0 0 8 -1 
0 0 5 0 0 0 0 6 -1 0 0 0 -1 0 0 0 -1 0 8 0 0 7 0 4 0 0 2 0 0 0 0 1 -1 0 0 3 
0 0 8 -1 0 1 7 0 2 0 0 -1 0 0 0 3 0 0 0 0 6 0 4 0 0 0 -1 0 0 0 0 0 -1 0 5 0 
0 5 0 0 0 6 0 0 -1 0 0 0 0 4 -1 7 0 0 0 0 3 0 0 0 0 0 0 -1 -1 0 2 0 0 0 1 8 
-1 6 0 7 0 0 0 0 0 0 0 0 0 0 0 4 0 0 5 0 -1 0 0 8 0 0 0 3 0 -1 2 0 0 0 1 -1 
0 0 0 0 0 -1 0 2 0 0 0 1 0 0 3 0 5 0 0 4 0 0 0 0 -1 0 7 0 6 0 8 0 0 0 -1 -1 
0 0 -1 0 0 -1 0 6 0 5 0 4 7 0 0 0 2 0 0 0 0 0 0 0 0 0 0 -1 0 0 8 -1 0 1 0 3 
0 0 0 1 8 0 2 0 3 0 7 0 0 0 0 0 0 -1 -1 0 4 -1 0 -1 0 0 0 0 0 6 5 0 0 0 0 0 
8 -1 -1 6 0 0 0 0 -1 0 5 0 -1 7 0 0 0 0 0 0 0 0 0 0 0 4 0 2 0 0 3 0 0 0 1 0 
0 0 3 0 0 0 0 0 0 5 -1 2 4 0 0 0 0 0 -1 6 0 -1 0 1 0 0 0 0 0 8 0 7 0 0 0 -1 
0 2 0 0 0 1 0 0 3 0 0 0 -1 -1 -1 0 0 4 0 0 5 0 7 0 0 -1 8 0 0 0 6 0 0 0 0 0 
0 0 1 0 0 0 0 2 0 0 0 7 3 0 0 -1 0 0 0 0 -1 6 0 0 4 0 -1 0 0 8 0 0 0 5 0 -1 
1 -1 2 0 0 0 0 0 0 0 0 3 0 0 7 0 4 -1 0 6 0 -1 0 0 0 0 0 8 -1 0 0 0 0 0 0 5 
0 0 0 0 7 -1 8 -1 0 0 0 0 1 0 0 0 0 0 0 2 0 5 0 6 0 0 0 0 0 -1 0 3 0 4 0 -1 
0 2 0 0 0 3 0 0 1 0 0 0 -1 0 0 0 0 -1 6 0 5 -1 0 0 0 -1 0 0 0 4 0 0 7 0 0 8 
0 0 2 0 -1 8 0 1 -1 0 -1 0 0 0 3 0 0 0 0 4 0 0 0 -1 0 0 5 0 0 0 0 6 0 0 0 7 
1 0 0 0 0 8 0 3 0 2 0 -1 0 -1 0 0 7 0 0 5 0 -1 0 0 4 0 0 0 6 0 0 0 -1 0 0 0 
-1 0 0 3 -1 -1 2 0 0 0 0 0 0 0 0 4 0 5 1 0 6 0 0 0 0 0 0 7 0 -1 0 0 0 0 0 8 
0 0 0 0 0 0 4 0 0 0 5 0 0 2 0 0 -1 6 0 0 1 0 -1 0 0 0 -1 7 0 0 3 0 -1 0 0 8 
0 6 0 0 0 0 0 0 0 0 5 0 0 7 0 0 0 1 -1 0 4 -1 0 0 8 0 0 3 0 2 -1 -1 0 0 0 0 
0 0 5 0 1 0 0 0 0 0 0 0 6 0 0 0 2 0 0 0 -1 4 -1 0 -1 0 7 0 0 0 8 0 0 -1 0 3 
0 0 0 0 7 0 0 0 0 -1 8 0 6 0 0 0 5 -1 0 4 0 0 0 -1 0 -1 1 0 0 0 0 3 0 0 0 2 
0 0 -1 0 0 3 1 0 2 0 -1 0 0 0 0 4 0 0 0 0 0 0 -1 8 0 0 0 5 0 0 6 0 0 0 7 -1 
-1 0 1 0 7 0 0 0 8 0 0 0 2 0 0 0 6 -1 0 0 0 -1 0 0 3 -1 5 0 0 0 0 0 0 4 0 0 
1 0 0 0 2 0 0 0 0 3 0 0 4 0 -1 -1 -1 8 -1 0 0 5 0 0 0 0 6 0 0 0 0 0 0 0 0 7 
4 0 -1 0 0 -1 0 0 0 5 0 6 0 0 -1 0 2 0 -1 3 0 0 0 0 0 0 0 0 0 0 0 1 8 0 0 7 
0 0 -1 0 0 0 0 2 0 4 0 5 0 0 0 0 0 0 0 0 -1 3 0 0 1 0 7 -1 -1 0 8 0 0 0 0 6 
0 0 0 -1 0 4 2 0 3 0 0 0 0 0 0 5 0 0 1 0 0 0 7 -1 0 0 0 0 0 -1 0 0 6 -1 0 8 
-1 0 4 0 0 0 -1 0 0 3 0 5 1 0 0 0 0 0 0 7 0 2 0 0 0 0 0 -1 0 0 8 -1 0 6 0 0 
0 0 0 0 0 0 0 0 3 0 2 0 0 0 0 0 -1 1 5 0 4 0 0 8 0 6 0 -1 0 -1 0 0 0 0 7 -1 
0 0 8 -1 0 6 0 0 7 0 0 0 0 0 -1 5 0 0 1 0 0 0 0 0 0 2 0 -1 0 4 0 0 3 0 0 -1 
0 0 0 7 0 0 0 0 0 0 1 8 0 2 0 0 -1 -1 0 0 6 0 3 -1 0 0 0 -1 0 0 5 0 0 0 4 0 
0 0 0 0 0 7 5 0 6 0 -1 0 0 0 -1 -1 8 0 4 0 0 0 3 0 0 0 0 1 0 0 2 0 0 0 0 -1 
0 0 0 0 7 0 0 0 0 -1 -1 0 6 0 2 0 -1 8 0 0 0 0 0 1 0 0 3 0 0 0 -1 5 0 0 0 4 
0 0 0 1 0 0 4 -1 3 -1 0 0 0 0 0 0 0 0 5 0 -1 0 2 0 0 6 0 7 0 0 0 0 0 0 -1 8 
0 1 0 0 0 -1 0 0 0 0 4 0 0 2 0 0 -1 0 0 0 3 0 5 0 0 6 0 0 -1 -1 0 0 7 0 0 8 
8 -1 0 0 0 0 0 0 0 -1 6 0 0 7 0 0 0 0 0 0 4 0 5 0 0 -1 -1 2 0 0 3 0 0 0 1 0 
0 0 0 0 0 1 0 0 2 0 0 0 0 0 -1 5 0 6 3 -1 -1 0 0 0 0 0 0 4 0 0 -1 8 0 0 7 0 
0 5 0 0 0 6 0 0 4 0 0 0 0 3 0 0 0 -1 0 0 2 0 7 -1 0 1 -1 0 0 0 0 0 0 0 -1 8 
0 8 -1 -1 0 0 0 -1 0 0 0 1 7 0 0 -1 3 0 0 2 0 0 0 0 0 0 0 0 0 0 0 6 0 5 0 4 
8 -1 0 1 0 0 0 0 0 0 4 0 0 2 0 0 0 5 7 0 0 0 3 0 0 0 -1 -1 0 0 0 0 0 0 6 -1 
4 0 0 0 5 -1 0 0 0 -1 0 0 0 0 3 0 6 0 0 0 0 0 -1 -1 2 0 0 0 7 0 0 0 0 1 8 0 
-1 -1 0 7 0 -1 6 0 0 -1 0 8 0 0 0 5 0 0 4 0 0 0 0 0 0 0 0 3 0 0 1 0 0 0 2 0 
1 -1 0 0 0 0 0 0 0 -1 0 2 7 0 0 0 0 0 0 0 0 6 -1 3 0 0 5 0 4 0 8 -1 0 0 0 0 
0 0 0 7 0 0 6 0 0 0 -1 8 0 3 0 5 0 0 0 -1 0 0 4 0 0 0 0 0 0 2 -1 -1 1 0 0 0 
8 0 0 0 0 7 -1 0 1 0 0 0 0 0 0 3 -1 0 2 0 0 0 0 0 -1 0 0 4 0 6 -1 0 5 0 0 0 
6 0 0 0 7 -1 0 0 8 0 0 -1 -1 0 5 0 0 0 0 0 0 1 0 4 2 0 3 0 0 0 -1 0 0 0 0 0 
0 0 4 0 3 0 0 1 0 0 0 0 5 0 0 0 2 0 0 0 -1 -1 0 7 0 0 6 0 0 0 0 0 -1 -1 8 0 
0 0 2 0 0 0 0 1 0 0 -1 3 0 0 0 0 -1 0 0 6 0 4 0 0 5 0 0 0 -1 8 0 0 -1 7 0 0 
0 0 6 0 0 0 0 5 8 0 0 7 -1 0 0 0 4 0 -1 -1 0 0 0 0 1 -1 0 0 3 0 0 0 0 2 0 0 
0 2 0 0 8 0 0 -1 1 0 -1 0 0 3 0 0 0 7 0 0 0 0 0 -1 0 0 0 -1 0 6 4 0 5 0 0 0 
0 0 0 3 0 0 2 0 0 0 1 0 0 0 0 5 0 4 0 -1 0 0 0 0 0 6 0 7 0 -1 0 0 -1 -1 0 8 
0 3 0 2 0 0 0 0 0 0 1 0 -1 0 -1 0 0 6 0 0 5 0 0 0 0 0 0 -1 0 7 4 0 -1 8 0 0 
0 0 -1 0 0 2 0 0 1 0 0 0 0 0 0 -1 0 3 5 0 4 0 0 0 0 0 -1 7 0 -1 6 0 0 0 0 8 
0 8 -1 0 0 0 0 7 0 6 0 5 1 0 0 -1 0 0 0 0 0 0 0 0 2 0 3 0 -1 0 0 0 -1 0 0 4 
0 4 -1 -1 0 2 0 0 0 0 0 0 0 7 0 3 0 0 5 0 0 0 1 0 0 0 0 0 0 -1 0 0 6 -1 0 8 
0 1 8 0 0 7 0 0 2 0 -1 0 0 0 0 0 0 0 0 0 -1 -1 6 0 0 3 0 0 0 0 0 0 4 -1 5 0 
0 3 0 0 0 0 0 -1 4 0 0 0 0 2 0 0 0 0 -1 0 0 0 5 0 8 0 0 1 0 6 -1 0 7 0 0 -1 
0 0 4 0 5 0 0 3 0 0 0 0 -1 0 0 0 0 0 0 0 0 2 0 0 1 -1 7 0 6 -1 8 0 0 0 0 -1 
3 0 0 0 2 0 0 0 -1 1 0 0 4 0 7 0 0 8 0 -1 0 0 0 6 0 0 0 0 -1 0 0 0 -1 5 0 0 
-1 0 0 0 4 -1 0 0 0 0 0 0 3 0 2 0 1 0 0 0 0 0 -1 5 -1 0 7 0 6 0 8 0 0 0 0 0 
0 0 3 0 0 0 0 -1 0 0 0 4 2 -1 5 0 0 0 0 0 0 0 -1 6 1 0 0 0 0 0 8 0 0 7 0 -1 
8 0 0 0 0 7 -1 -1 -1 0 0 0 0 1 0 0 0 0 0 -1 5 0 6 0 0 0 0 0 0 4 2 0 3 0 0 0 
0 3 -1 1 0 0 0 0 0 0 2 0 0 4 0 0 -1 -1 0 0 5 0 -1 8 0 0 0 0 0 0 6 0 7 0 0 0 
0 0 2 -1 0 8 0 0 0 0 0 -1 3 0 1 0 0 0 0 0 -1 -1 0 7 4 0 5 0 0 0 0 0 0 0 0 6 
8 -1 0 0 0 6 0 0 7 0 0 0 0 0 0 0 0 0 3 -1 2 0 -1 0 0 1 0 0 -1 5 0 0 4 0 0 0 
-1 0 6 0 7 0 0 0 0 0 -1 0 0 0 0 0 -1 8 0 0 0 5 0 1 4 0 3 0 0 0 0 0 -1 0 0 2 
0 0 0 6 0 0 0 -1 5 0 0 0 0 0 0 -1 0 7 1 0 0 0 4 0 0 2 0 0 -1 0 0 0 3 0 -1 8 
8 -1 0 2 0 0 0 0 0 0 1 0 0 7 0 0 0 3 0 0 4 0 0 -1 -1 0 0 6 0 5 -1 0 0 0 0 0 
0 0 1 -1 0 0 0 2 0 -1 0 4 0 0 0 0 3 0 0 0 0 5 0 0 0 -1 0 0 7 0 0 6 0 -1 8 0 
-1 0 0 0 3 0 -1 4 0 2 0 0 0 0 0 0 1 -1 0 5 0 0 0 6 0 0 7 0 0 0 8 -1 0 0 0 0 
8 -1 0 0 0 4 0 -1 5 0 0 0 0 0 0 -1 0 0 7 0 0 0 6 0 0 1 0 0 0 3 0 0 2 0 0 -1 
0 0 1 8 0 0 0 0 0 3 0 7 2 0 4 0 0 0 -1 0 0 -1 0 0 5 0 0 0 6 -1 0 0 0 0 0 -1 
0 0 0 0 4 0 0 0 0 3 -1 0 0 0 2 0 5 0 0 -1 0 0 0 -1 1 0 7 -1 0 0 8 0 0 0 0 6 
0 0 3 -1 -1 8 0 0 0 0 -1 0 0 0 2 0 7 0 0 4 0 0 0 0 0 0 1 0 6 0 0 5 0 0 0 -1 
2 0 0 0 1 8 0 -1 0 4 -1 0 0 0 0 0 0 0 0 3 0 5 0 7 -1 0 0 0 0 0 -1 6 0 0 0 0 
0 0 0 1 -1 -1 2 0 0 0 3 0 0 0 0 0 0 0 4 0 0 0 5 0 0 7 0 0 0 0 0 8 -1 0 6 -1 
0 8 -1 -1 4 0 0 7 0 -1 0 0 6 0 0 0 0 0 0 0 0 5 0 0 0 0 3 0 0 -1 0 2 0 0 0 1 
-1 0 0 4 0 3 -1 0 0 0 0 0 0 5 0 2 0 0 0 0 0 0 0 0 0 -1 0 7 0 1 6 0 0 -1 0 8 
0 0 4 0 5 0 0 -1 0 0 0 0 3 0 0 0 6 0 0 0 0 2 -1 0 1 -1 -1 0 0 0 8 0 0 7 0 0 
0 0 7 0 0 8 0 6 0 0 0 5 4 0 0 0 -1 0 0 -1 -1 0 0 0 0 0 0 0 2 0 -1 3 0 1 0 0 
0 0 0 0 0 4 5 -1 0 0 -1 0 0 0 0 3 0 0 0 0 2 0 0 -1 0 0 0 -1 0 1 6 0 7 0 0 8 
0 0 -1 0 0 7 2 0 1 8 -1 0 0 0 0 3 0 0 -1 0 4 0 0 0 0 0 0 5 0 6 0 0 0 0 0 -1 
0 6 0 0 0 -1 0 0 7 -1 0 0 8 0 0 -1 0 0 1 0 0 0 5 -1 0 0 0 2 0 0 3 0 0 0 4 0 
0 0 6 0 7 0 0 5 0 0 0 0 -1 -1 0 0 4 8 -1 0 0 -1 0 0 0 0 0 0 3 0 0 2 0 0 0 1 
2 0 0 0 1 8 0 -1 0 0 0 0 0 0 0 0 7 0 -1 3 0 0 0 -1 4 0 0 -1 6 0 0 0 0 5 0 0 
-1 0 5 0 6 -1 0 0 0 0 0 0 4 0 0 0 0 0 0 0 0 3 0 7 2 0 0 -1 -1 0 0 0 0 1 8 0 
