0 0 0 0 0 0 0 0 7 0 0 0 0 0 -1 0 0 0 0 6 -1 5 0 0 0 0 2 0 0 -1 0 0 0 0 -1 3 0 4 0 0 0 0 -1 0 0 0 8 0 0 1 -1 -1 0 0 0 0 10 0 0 0 0 0 9 0 
-1 0 9 0 0 0 10 -1 -1 0 0 8 0 0 0 7 0 0 0 0 0 0 0 0 0 1 0 0 -1 0 0 0 -1 0 3 0 2 0 0 0 0 0 0 0 0 0 0 0 4 0 0 0 0 0 -1 0 0 0 -1 5 0 0 0 6 
0 0 0 -1 0 5 0 0 8 0 0 0 0 0 4 0 -1 0 0 0 -1 6 0 0 0 0 7 0 0 0 -1 0 0 -1 0 2 0 0 0 3 0 -1 0 0 1 0 0 -1 0 0 0 0 0 0 0 0 10 0 0 0 9 0 0 0 
5 0 -1 0 0 0 0 0 0 0 0 4 0 0 0 3 0 0 6 0 -1 -1 0 0 0 7 0 0 0 0 0 2 0 0 -1 -1 0 0 0 0 0 0 -1 1 0 0 0 0 0 0 0 0 8 0 0 0 0 0 -1 10 0 0 0 9 
0 0 -1 0 0 0 0 2 0 0 -1 0 0 0 1 0 0 0 -1 0 0 0 0 0 4 0 3 0 6 0 0 -1 0 -1 0 0 0 -1 0 7 0 0 5 0 8 0 0 0 0 0 0 0 0 9 0 0 0 0 0 0 0 -1 10 0 
1 0 0 0 0 0 0 0 0 5 0 0 0 -1 0 2 0 -1 0 0 0 -1 0 0 0 -1 0 4 0 0 0 3 0 -1 10 0 0 -1 9 0 0 0 0 6 0 0 0 0 7 0 0 0 -1 0 0 0 0 0 0 8 0 0 0 0 
2 0 0 0 0 0 0 0 0 0 -1 0 0 0 0 0 -1 0 1 0 0 0 3 0 0 6 0 0 0 4 0 0 0 0 7 -1 5 0 -1 -1 0 0 0 0 0 0 -1 10 0 0 0 0 8 0 9 0 0 0 0 -1 0 0 0 0 
0 0 0 0 3 0 0 0 0 0 0 2 0 0 -1 0 6 0 -1 0 0 0 1 0 0 0 0 5 0 0 0 4 0 0 7 0 0 0 -1 -1 0 0 0 0 0 8 0 0 0 0 0 -1 9 0 0 0 0 0 0 10 -1 -1 0 0 
0 0 0 2 0 0 0 3 0 0 0 0 1 -1 0 0 0 5 0 0 0 4 0 10 0 0 0 0 0 -1 0 0 0 0 0 0 0 -1 0 -1 6 0 0 0 7 -1 0 0 0 8 0 0 0 -1 0 0 0 0 0 0 0 0 9 -1 
0 0 2 0 10 0 0 0 0 3 -1 0 0 1 0 9 -1 0 0 0 0 0 0 0 0 0 -1 -1 0 0 0 8 5 0 0 0 4 -1 0 0 0 0 0 0 0 0 0 0 6 0 -1 -1 0 0 0 0 0 0 0 7 0 0 0 0 
10 -1 0 0 0 0 0 0 0 0 0 -1 0 0 -1 9 1 0 0 0 2 0 0 0 0 0 0 0 -1 3 0 0 0 0 0 0 -1 0 0 0 0 0 0 5 0 -1 0 8 6 0 7 0 0 0 4 0 0 0 -1 0 0 0 0 0 
-1 0 0 2 0 0 0 3 -1 0 1 0 4 0 0 0 0 0 0 0 0 0 0 9 0 0 5 0 0 0 0 0 0 0 0 0 0 -1 0 0 6 0 0 -1 8 0 0 0 0 0 0 0 0 0 -1 0 -1 0 7 0 0 -1 10 0 
0 0 0 0 0 0 0 5 0 0 0 0 3 0 0 0 0 -1 0 0 -1 0 0 -1 0 0 4 0 2 0 6 0 0 0 -1 0 0 0 0 0 -1 0 0 0 0 0 0 0 -1 1 -1 9 0 8 0 7 10 0 0 0 0 0 0 0 
0 4 0 5 0 6 -1 -1 0 0 0 0 0 0 0 0 0 0 0 0 0 8 -1 7 0 0 3 0 0 0 0 0 0 2 0 0 0 0 -1 -1 0 0 -1 0 1 0 0 0 0 0 0 9 0 0 0 0 0 0 0 0 0 0 10 -1 
0 0 0 3 0 0 0 0 2 0 0 0 1 0 0 0 0 0 0 0 0 4 -1 10 0 0 5 0 0 0 0 0 -1 -1 0 6 0 0 0 0 7 0 0 0 0 0 0 0 0 0 -1 0 0 0 0 9 -1 0 8 0 -1 -1 0 0 
-1 0 0 0 0 6 0 0 4 0 5 0 0 0 -1 0 0 3 0 -1 0 0 -1 7 0 0 0 0 2 0 -1 0 0 0 0 0 0 0 0 0 1 -1 10 0 0 0 0 0 0 0 0 0 0 9 -1 0 0 0 0 0 0 0 8 0 
4 0 0 -1 0 0 6 0 0 -1 0 0 0 0 0 0 0 -1 0 0 0 0 7 -1 0 -1 0 5 0 -1 0 0 3 0 0 0 2 0 0 0 0 0 0 0 0 0 0 8 0 -1 0 0 9 0 0 0 0 1 0 0 0 0 0 10 
0 0 0 0 0 0 0 -1 0 10 -1 -1 0 9 0 0 0 0 2 0 0 0 0 0 0 1 0 0 -1 0 0 0 0 0 0 0 3 0 8 0 0 -1 -1 0 0 0 0 0 4 0 5 0 6 0 -1 0 0 0 0 0 0 0 0 7 
0 0 0 -1 0 0 0 0 0 5 0 -1 0 8 -1 0 0 0 6 0 -1 0 0 0 0 0 0 0 0 7 0 9 0 0 -1 -1 10 0 0 0 -1 0 0 0 0 0 0 4 0 0 2 0 0 0 1 0 0 0 0 0 0 3 0 0 
0 0 0 2 0 0 0 1 3 0 0 0 0 -1 0 0 0 4 0 0 0 10 0 9 0 0 5 -1 0 0 0 0 0 0 0 0 0 -1 0 0 0 0 0 0 0 0 6 0 0 -1 -1 0 0 8 -1 0 0 0 7 0 -1 0 0 0 
0 0 0 0 0 0 0 -1 3 0 0 0 0 0 0 0 0 0 0 0 0 0 -1 0 2 0 0 0 1 0 4 0 0 0 0 5 0 0 0 9 6 -1 -1 -1 10 0 0 0 0 7 0 8 0 0 0 0 0 0 0 0 -1 0 0 -1 
0 0 0 7 0 0 0 0 0 0 0 0 0 0 0 0 -1 8 0 0 0 -1 0 0 0 0 0 0 -1 -1 5 0 0 4 0 0 -1 -1 0 6 9 0 0 0 0 0 0 0 0 0 0 10 -1 0 0 3 1 0 0 0 2 0 0 0 
0 0 0 4 0 0 0 0 3 0 0 0 0 0 0 0 -1 1 0 0 0 2 0 0 -1 -1 -1 0 0 0 5 0 0 9 0 0 0 0 0 0 0 -1 0 0 0 0 0 0 0 -1 0 0 0 6 0 0 10 -1 8 0 0 0 7 0 
0 1 -1 0 0 3 0 0 0 0 2 0 -1 0 0 0 -1 0 0 0 0 0 0 0 -1 0 4 0 0 0 0 0 0 0 0 7 0 0 0 0 8 0 0 0 0 0 -1 0 0 0 0 9 0 6 0 5 10 -1 0 0 0 -1 0 0 
0 9 0 0 0 0 0 8 0 0 10 -1 -1 0 0 0 0 0 -1 0 0 0 0 0 0 0 -1 0 0 0 0 0 -1 0 0 2 0 0 0 7 1 0 -1 0 0 0 3 0 0 0 0 4 -1 0 0 0 5 0 0 0 0 0 6 0 
0 0 0 -1 0 0 0 10 8 0 9 0 0 0 0 -1 -1 0 0 7 0 0 0 0 0 0 0 0 0 0 1 0 0 -1 0 0 0 0 0 0 2 0 3 0 4 0 5 0 0 0 -1 0 0 -1 0 6 0 0 0 0 0 -1 0 0 
-1 0 0 0 0 0 0 0 3 0 4 0 5 0 0 0 0 0 0 2 0 0 0 0 0 0 0 0 -1 0 0 -1 0 0 0 1 0 0 0 0 8 0 0 0 7 0 6 0 0 -1 0 0 -1 -1 -1 10 0 0 9 0 0 0 0 0 
0 0 2 0 0 0 3 -1 0 1 0 4 0 0 0 10 0 0 0 0 0 -1 0 0 0 0 0 -1 0 0 0 9 0 -1 0 0 5 0 0 0 0 0 0 6 0 -1 0 0 0 0 0 0 0 -1 0 0 0 7 0 0 0 8 0 -1 
-1 0 0 0 0 0 0 -1 -1 2 0 0 0 0 0 3 0 0 0 0 0 0 0 0 0 1 0 0 0 5 0 4 0 0 6 -1 -1 0 0 0 0 7 -1 0 0 9 0 0 0 0 10 0 0 0 0 0 0 0 0 0 0 -1 0 8 
0 1 0 9 0 0 0 0 0 -1 0 0 10 -1 0 0 0 -1 0 0 0 0 0 -1 2 0 0 -1 0 0 8 0 0 3 0 0 0 6 0 0 0 -1 5 0 0 0 0 0 0 0 0 0 0 0 0 7 4 0 -1 0 0 0 0 0 
0 0 0 0 0 0 2 0 0 1 0 0 0 0 0 0 0 0 3 0 0 0 0 0 0 -1 -1 0 0 0 0 0 4 0 -1 0 8 0 9 0 -1 0 0 0 0 0 0 0 5 0 0 -1 6 0 7 0 0 0 0 -1 0 0 -1 10 
-1 3 0 4 0 0 0 0 0 0 0 0 0 0 -1 0 0 2 0 0 0 5 -1 0 0 0 -1 0 0 0 0 0 0 0 -1 0 0 7 0 6 0 0 0 0 -1 0 0 -1 0 1 0 9 0 8 0 0 10 0 0 0 0 0 0 0 
0 0 0 0 -1 0 0 0 3 0 4 0 5 0 0 0 0 0 0 2 0 0 0 0 0 0 0 0 0 0 -1 0 0 -1 -1 0 0 6 0 0 0 0 1 0 -1 0 8 0 -1 0 0 7 0 0 0 0 10 0 9 0 0 0 0 -1 
0 0 0 0 -1 -1 4 0 0 0 0 6 0 0 0 0 0 0 5 0 0 0 0 0 0 -1 0 0 0 -1 0 3 7 0 0 -1 0 0 0 -1 0 0 0 2 0 0 0 1 0 0 0 0 9 0 0 0 0 8 -1 10 0 0 0 0 
1 0 0 0 0 0 0 0 0 0 0 -1 0 0 0 2 0 -1 0 0 3 0 9 0 0 -1 0 0 -1 0 0 0 4 0 6 0 7 0 8 0 0 0 0 0 0 0 0 0 0 0 0 0 5 -1 0 -1 0 0 0 0 0 -1 0 10 
0 0 0 0 0 5 0 0 0 -1 0 0 0 0 0 0 0 0 0 4 0 6 0 0 -1 -1 -1 0 0 0 0 0 0 0 0 3 0 0 0 7 2 0 0 0 1 -1 0 0 0 0 0 9 0 0 0 8 10 -1 -1 0 0 0 0 0 
-1 2 0 0 0 1 0 0 -1 0 0 0 0 -1 0 0 0 3 0 0 0 10 0 0 0 0 4 0 0 0 0 0 0 6 0 5 0 0 0 0 0 0 0 0 -1 0 0 0 0 7 -1 0 0 0 0 -1 0 0 8 0 9 0 0 -1 
0 0 0 9 0 0 0 0 10 -1 -1 0 0 0 0 0 0 3 0 0 0 4 0 0 0 0 -1 0 6 -1 0 0 0 2 -1 0 0 -1 0 0 0 0 1 0 0 0 5 0 0 0 0 0 0 0 0 0 0 0 0 0 7 -1 8 0 
0 5 0 0 0 6 0 0 0 0 0 -1 0 0 -1 0 0 0 0 -1 0 0 0 0 4 0 3 0 0 0 7 0 0 0 -1 0 0 0 0 0 0 0 0 0 2 0 0 0 0 -1 -1 0 0 10 -1 8 0 0 1 0 9 0 0 0 
2 0 0 0 0 -1 0 0 0 0 0 0 0 0 0 0 0 0 -1 0 0 0 1 0 0 8 0 -1 0 0 0 3 9 0 0 0 0 0 0 0 0 7 0 0 0 6 -1 0 0 -1 -1 0 0 0 4 0 0 10 -1 5 0 0 0 0 
0 0 0 0 0 0 0 0 10 -1 9 0 -1 0 8 0 0 0 0 0 0 0 0 7 2 0 0 0 0 0 0 0 0 0 -1 1 -1 0 0 0 4 0 -1 0 3 0 -1 0 0 0 0 0 -1 5 0 6 0 0 0 0 0 0 0 0 
-1 0 0 0 0 0 0 3 -1 0 2 0 0 0 1 0 0 6 -1 5 0 4 0 0 0 0 0 0 0 0 0 0 0 7 0 0 0 0 0 0 0 0 10 -1 0 0 -1 0 0 0 -1 9 0 8 0 0 -1 0 0 0 0 0 0 0 
0 2 0 0 0 1 -1 -1 0 0 0 0 0 -1 0 0 0 0 0 3 0 10 0 0 4 0 0 0 0 0 0 0 -1 -1 0 0 0 5 0 0 0 0 0 -1 0 0 9 0 0 -1 0 7 0 8 0 0 6 0 0 0 0 0 0 0 
0 0 0 0 5 0 0 0 0 0 0 4 0 0 -1 6 3 0 0 0 0 0 0 0 0 0 0 2 0 0 0 7 0 0 -1 -1 1 0 -1 0 0 0 0 -1 -1 0 0 0 0 0 8 0 0 0 10 0 -1 0 0 0 0 9 0 0 
2 0 0 0 0 0 0 -1 0 0 0 3 0 0 0 0 -1 0 0 0 0 0 1 0 0 0 0 0 0 4 0 0 0 -1 0 0 -1 0 0 0 0 5 0 6 0 0 -1 0 10 -1 -1 0 0 0 0 0 0 0 0 9 0 8 0 7 
0 0 0 0 0 0 4 0 0 -1 0 0 0 0 0 0 3 0 5 0 -1 -1 0 0 -1 0 0 0 0 0 0 0 0 0 2 -1 6 0 7 0 0 0 0 0 0 1 0 0 10 0 9 0 -1 0 0 0 -1 0 0 0 0 8 0 0 
0 0 2 0 0 0 3 0 0 1 0 0 0 10 -1 0 9 0 0 -1 0 0 4 0 0 0 0 -1 0 0 0 0 0 -1 -1 0 0 0 -1 0 0 7 0 0 0 0 0 0 8 0 0 0 0 0 0 0 0 0 -1 6 0 0 0 5 
0 4 0 0 0 5 0 0 0 0 0 -1 0 0 0 0 0 0 0 -1 0 6 0 0 3 -1 0 0 0 -1 -1 0 0 0 0 -1 0 2 0 7 0 0 0 0 0 0 0 0 0 0 0 1 -1 0 0 0 10 0 0 0 9 0 8 0 
0 0 2 0 0 0 3 -1 0 0 0 0 0 1 0 -1 9 0 0 0 0 -1 0 0 0 0 0 0 0 10 -1 4 -1 0 0 0 5 0 0 0 0 0 0 0 0 0 0 -1 0 0 0 0 0 0 6 0 -1 8 0 0 0 7 0 0 
0 0 -1 0 7 0 0 0 0 0 0 0 0 9 0 8 6 0 10 0 0 0 0 -1 -1 0 0 5 0 0 0 4 -1 0 0 0 0 0 0 0 -1 0 0 0 0 1 0 0 -1 0 2 0 0 0 0 0 -1 0 0 0 0 0 0 3 
0 0 0 0 -1 -1 7 0 0 5 0 6 0 0 0 0 0 -1 4 0 0 0 3 0 0 0 0 0 0 0 0 8 0 0 0 0 -1 0 0 0 0 2 0 0 0 1 -1 0 10 0 0 0 9 0 0 0 -1 0 0 0 0 -1 0 0 
0 0 0 0 -1 10 0 0 0 0 0 0 -1 0 0 0 0 6 0 -1 -1 0 0 9 0 -1 0 0 0 0 0 0 0 5 0 7 -1 0 0 0 0 0 0 0 3 0 8 0 0 4 0 -1 0 0 0 2 1 0 0 0 0 0 0 0 
-1 -1 0 0 0 0 8 0 0 0 0 0 0 7 0 0 0 0 0 0 6 0 0 0 0 5 0 0 0 4 0 9 0 0 0 0 3 0 0 0 0 0 -1 10 0 0 0 0 0 0 -1 -1 -1 0 0 -1 0 0 0 2 0 0 0 1 
0 4 0 0 0 0 0 6 0 0 0 0 5 0 0 0 0 3 0 0 -1 -1 0 -1 0 0 0 -1 0 0 7 0 0 0 0 -1 0 0 0 0 0 0 2 -1 0 0 0 0 0 1 0 9 0 0 -1 8 10 0 0 0 0 0 0 0 
0 0 0 2 0 0 0 1 3 0 0 0 4 0 0 -1 0 0 0 0 0 5 0 10 0 0 6 0 0 0 -1 0 0 0 -1 0 0 0 0 0 -1 0 0 0 0 0 0 0 0 0 0 8 -1 0 0 9 7 0 0 0 -1 0 0 -1 
10 0 0 0 0 0 0 -1 0 0 0 0 0 -1 0 9 0 -1 0 0 0 0 0 0 0 2 0 3 -1 0 0 0 0 0 -1 0 0 0 4 0 0 1 0 5 0 0 0 8 6 0 0 0 0 0 0 0 0 0 0 7 -1 -1 0 0 
0 0 0 2 0 0 0 1 3 0 0 0 4 0 0 0 0 0 0 0 0 0 0 0 5 0 0 0 0 0 0 -1 0 8 -1 10 0 0 0 -1 0 0 0 -1 0 0 0 0 0 -1 0 9 0 0 0 6 0 0 0 0 7 0 -1 -1 
0 3 0 0 0 4 0 0 0 0 2 0 0 0 1 0 0 8 0 5 0 0 0 0 0 -1 0 0 -1 -1 6 0 0 -1 0 0 0 0 0 0 9 0 0 0 0 0 -1 0 0 0 0 0 -1 7 0 0 10 -1 0 0 0 0 0 0 
0 0 0 0 3 0 0 0 0 0 -1 -1 0 10 -1 0 -1 0 2 0 0 0 0 0 0 0 -1 0 0 1 0 0 6 0 -1 0 0 0 0 0 0 7 0 8 0 9 0 4 0 0 0 0 0 -1 0 0 0 5 0 0 0 0 0 0 
0 0 0 0 0 -1 4 0 0 2 0 0 0 0 0 0 0 0 0 0 3 0 5 0 0 1 0 0 -1 0 0 -1 0 0 0 0 6 0 0 0 0 7 0 0 0 0 0 0 8 0 0 0 -1 -1 -1 0 0 0 0 9 -1 10 0 0 
-1 3 0 0 0 2 0 0 0 0 10 0 0 0 -1 0 0 0 -1 0 0 0 -1 1 0 0 0 0 -1 0 9 0 0 4 0 0 0 0 0 0 0 0 0 0 0 0 5 0 0 0 0 7 -1 0 0 8 6 0 -1 0 0 0 0 0 
0 0 0 0 -1 0 0 0 0 -1 -1 9 0 8 0 0 0 0 0 -1 0 0 0 -1 0 0 0 10 -1 -1 0 0 6 0 0 0 7 0 0 0 0 0 0 0 0 0 0 1 0 0 2 0 0 0 3 0 0 5 0 0 0 4 0 0 
0 0 0 0 2 0 0 -1 0 -1 -1 0 0 3 0 -1 0 0 1 0 4 0 0 0 -1 0 0 6 0 0 0 5 7 0 10 -1 0 0 0 0 0 0 0 -1 0 8 0 0 0 0 0 0 9 0 0 0 0 0 0 0 0 0 0 0 
4 0 0 0 5 0 0 0 0 0 -1 0 0 0 0 0 -1 0 3 0 0 0 0 0 0 0 0 -1 0 0 0 0 2 0 0 0 1 0 0 -1 0 6 0 0 0 0 -1 10 0 0 0 0 0 0 9 0 0 7 0 8 -1 -1 0 0 
0 0 0 0 0 2 -1 1 0 0 0 -1 -1 0 0 0 0 0 0 10 0 0 0 0 3 0 0 0 4 0 0 0 0 0 0 0 -1 5 0 0 0 0 0 0 0 0 -1 0 0 6 0 0 0 8 -1 9 0 0 7 0 -1 0 0 0 
0 0 0 -1 0 2 0 0 0 0 4 -1 0 0 1 0 0 0 0 0 0 0 0 3 0 0 5 0 -1 0 7 0 -1 6 0 0 0 0 -1 0 -1 0 0 0 0 0 0 0 0 0 0 8 0 0 -1 10 9 0 0 0 0 0 0 0 
0 0 2 0 10 0 0 0 0 -1 -1 0 0 1 0 0 3 0 0 0 4 -1 0 0 0 5 0 0 0 0 -1 0 0 0 0 0 0 0 0 0 0 6 0 7 0 0 0 0 0 0 -1 0 0 0 0 0 0 0 -1 -1 0 8 0 9 
0 0 0 0 0 -1 0 5 3 0 4 0 0 0 0 0 -1 0 0 0 0 0 0 0 2 0 0 0 0 0 6 -1 0 0 0 1 0 0 0 0 -1 -1 10 -1 0 0 7 0 0 0 0 9 0 0 0 0 0 0 0 0 -1 0 8 0 
-1 -1 -1 0 0 0 0 0 0 6 0 0 0 0 0 0 0 0 0 0 0 0 7 0 0 0 -1 0 0 4 -1 0 5 0 -1 0 3 0 0 0 -1 1 0 0 0 2 0 8 9 0 0 0 0 0 0 0 0 0 0 0 0 0 0 10 
10 0 0 0 0 0 0 0 0 0 0 2 0 0 -1 9 0 0 0 0 1 0 3 0 0 5 -1 4 0 -1 0 0 0 0 0 0 0 0 0 0 0 6 -1 -1 0 0 0 8 0 0 0 0 7 -1 0 0 0 0 0 -1 0 0 0 0 
9 0 0 0 8 -1 0 0 0 7 0 0 0 -1 0 0 0 0 0 0 6 0 0 0 0 10 -1 1 0 0 0 5 -1 -1 0 0 0 -1 0 0 0 3 0 2 0 0 0 0 0 0 0 0 -1 0 0 0 0 0 0 0 0 0 0 4 
0 2 0 0 0 1 0 10 0 0 3 -1 0 0 0 -1 0 0 0 5 0 6 0 -1 4 0 0 0 0 0 0 -1 0 7 0 0 0 -1 0 0 0 0 0 0 -1 0 9 0 0 0 -1 0 0 0 0 0 0 0 0 0 8 0 0 0 
6 0 0 0 7 0 0 0 0 -1 0 0 0 9 -1 10 0 -1 0 0 0 0 0 -1 0 -1 0 -1 0 0 0 0 5 0 8 0 0 0 0 0 -1 0 0 4 0 0 0 3 0 0 0 0 2 0 0 0 0 0 0 0 0 0 0 1 
0 0 0 2 0 0 -1 10 0 0 0 0 1 0 0 0 0 0 0 0 0 0 0 0 3 -1 0 0 0 0 7 0 0 0 0 -1 0 0 0 0 -1 0 0 0 8 0 -1 0 0 4 -1 6 0 0 0 0 0 0 5 0 0 -1 9 0 
0 0 6 0 7 0 0 -1 0 -1 0 0 -1 -1 0 0 5 0 4 0 0 -1 0 0 0 0 0 0 0 -1 0 8 3 0 0 0 0 0 0 0 0 0 0 0 0 0 0 0 10 -1 2 0 0 0 1 0 0 0 0 0 0 0 0 9 
3 0 0 0 2 0 0 0 0 0 -1 10 0 0 -1 0 4 0 9 0 0 0 -1 0 0 0 0 0 0 0 -1 0 0 0 8 0 -1 -1 1 0 0 0 0 0 0 -1 0 0 0 0 0 0 0 0 7 0 0 0 0 5 0 0 0 6 
0 0 1 0 3 0 0 0 0 -1 -1 0 0 0 0 4 2 0 0 0 0 0 0 0 0 0 0 8 0 0 0 0 9 -1 -1 0 0 0 0 0 0 -1 0 0 0 5 0 0 0 -1 7 0 0 0 6 0 0 10 -1 0 0 0 0 0 
0 5 -1 6 0 0 0 0 0 0 0 0 -1 0 0 0 0 0 -1 4 0 7 0 0 -1 0 0 0 0 0 3 0 0 0 0 2 0 0 0 8 0 0 0 0 1 -1 -1 0 0 0 0 9 0 0 0 0 0 0 0 0 10 -1 0 0 
0 0 0 -1 -1 1 0 0 2 -1 0 0 0 0 0 0 0 0 0 3 0 0 0 4 0 0 0 -1 10 0 -1 0 0 -1 0 0 -1 0 0 0 0 0 8 0 9 0 5 0 0 0 0 0 0 0 0 0 0 0 0 0 7 0 6 0 
0 0 0 0 -1 -1 0 5 3 0 4 0 0 0 0 0 0 0 0 2 0 0 0 0 0 0 0 0 0 0 6 0 0 1 0 0 0 0 -1 -1 0 0 9 -1 0 0 0 0 0 -1 0 0 0 0 0 7 10 -1 8 0 0 0 0 0 
0 0 0 0 0 7 0 0 0 0 0 0 4 0 0 0 0 5 -1 -1 0 0 0 0 6 0 0 0 -1 0 3 0 0 0 0 0 -1 0 0 8 0 0 2 0 0 0 0 0 0 1 -1 0 0 0 0 0 -1 -1 10 0 9 0 0 0 
0 0 4 0 0 0 5 0 0 0 0 0 0 -1 0 0 3 0 0 0 0 -1 6 0 0 0 0 -1 0 7 0 0 0 0 2 0 0 -1 10 -1 0 0 0 8 0 0 0 0 0 0 0 -1 9 0 -1 0 0 0 0 1 0 0 0 0 
0 0 4 0 0 -1 0 0 0 3 0 0 0 5 0 6 0 0 2 0 9 0 0 0 0 1 0 0 0 0 0 -1 10 -1 0 -1 -1 0 7 0 0 0 0 0 -1 8 0 0 0 0 0 0 0 0 0 0 0 0 0 -1 0 0 0 0 
0 0 0 0 9 0 0 0 0 0 0 10 -1 0 0 0 0 0 2 0 0 0 3 0 0 1 -1 4 0 0 0 8 0 0 0 0 -1 -1 0 0 0 0 -1 0 0 0 0 -1 5 0 -1 0 7 0 0 0 0 0 0 6 0 0 0 0 
0 0 0 0 0 3 0 0 0 0 2 0 0 0 1 0 0 0 0 0 0 0 0 4 5 0 0 -1 0 0 0 -1 -1 6 0 10 0 -1 0 0 0 0 0 0 0 -1 0 0 0 7 0 8 0 0 0 0 -1 0 0 0 -1 0 9 0 
0 6 0 0 0 0 0 5 0 0 7 0 -1 0 0 0 0 10 -1 0 0 8 -1 0 0 0 0 0 0 0 -1 0 -1 9 0 0 0 -1 -1 4 0 0 0 0 0 0 0 0 0 0 0 3 0 0 0 0 1 0 0 0 2 0 0 0 
0 5 0 -1 0 0 0 0 0 0 0 0 6 0 0 0 0 4 0 0 0 7 -1 -1 0 0 3 -1 0 0 0 0 0 2 0 0 0 0 0 8 0 -1 10 -1 0 0 9 0 0 0 0 0 0 0 0 0 -1 0 0 0 1 0 0 0 
0 0 0 0 0 5 0 0 0 -1 4 0 0 0 3 0 0 0 0 0 0 -1 0 6 -1 0 0 0 0 0 0 0 -1 2 0 0 0 1 -1 0 8 0 0 0 -1 0 0 0 0 9 0 7 0 0 0 0 0 0 0 0 10 -1 0 0 
0 0 0 8 0 0 0 0 0 0 0 0 0 0 9 0 0 7 -1 -1 0 0 0 10 0 0 -1 0 4 -1 6 0 0 0 0 0 0 -1 0 0 0 0 3 0 0 0 5 -1 0 0 -1 1 0 0 0 0 2 0 0 0 0 0 0 0 
0 3 0 4 0 0 0 5 0 0 0 0 0 0 0 0 0 -1 -1 0 0 0 0 0 0 0 10 0 -1 0 -1 -1 0 0 -1 0 0 6 0 0 0 0 0 0 9 0 7 0 0 0 0 2 -1 0 0 0 0 0 0 0 1 0 8 0 
0 0 1 0 3 0 0 0 0 2 0 0 -1 0 0 0 6 0 0 0 0 0 4 0 0 0 0 0 0 5 -1 0 -1 0 -1 0 0 0 0 0 0 7 -1 0 0 9 0 0 0 0 0 0 0 0 -1 -1 0 8 0 0 0 0 0 10 
0 0 0 0 0 0 0 0 0 0 6 0 7 0 0 0 0 0 0 5 0 0 -1 8 0 0 0 0 3 0 -1 0 0 0 0 -1 0 4 -1 0 0 0 0 -1 0 0 0 0 0 2 0 0 0 1 0 -1 10 0 0 0 9 0 0 -1 
0 0 0 -1 -1 0 0 6 0 0 3 -1 -1 0 0 0 0 0 -1 -1 0 5 0 0 0 0 4 0 0 0 0 0 0 0 0 0 0 0 0 7 1 0 0 0 2 0 0 0 0 0 0 0 0 0 0 0 10 -1 9 0 8 0 0 0 
0 0 0 0 0 0 0 0 4 0 5 0 0 0 6 0 0 0 0 3 0 0 -1 0 2 0 0 0 7 0 0 0 0 -1 0 0 0 -1 0 0 0 0 8 0 0 0 -1 -1 0 0 -1 10 0 0 0 0 0 0 1 -1 0 0 9 0 
3 0 0 -1 0 0 0 0 0 -1 0 4 0 5 0 6 0 0 10 0 -1 -1 0 0 -1 0 0 0 0 0 0 7 2 0 0 -1 0 0 -1 0 0 0 0 1 0 8 0 0 0 0 0 0 0 0 0 0 0 0 0 9 0 0 0 0 
0 0 0 2 0 0 0 1 3 0 0 0 0 -1 0 0 -1 4 0 0 0 0 0 0 -1 0 0 0 -1 0 0 0 0 8 0 0 0 -1 0 0 0 0 0 0 0 0 0 0 -1 9 0 7 0 6 0 5 10 0 0 -1 0 0 0 0 
0 9 0 0 0 0 0 -1 0 0 10 -1 0 0 0 0 0 0 0 0 0 0 0 0 2 0 0 0 1 -1 0 0 0 4 -1 3 0 0 0 8 0 0 0 0 -1 0 0 0 0 -1 0 6 0 0 0 0 5 0 0 -1 0 0 7 0 
0 0 0 0 0 0 0 10 6 -1 7 0 0 0 0 -1 0 0 0 5 0 8 0 9 4 0 0 0 -1 0 0 0 0 0 0 -1 0 0 0 2 0 0 0 0 3 -1 0 0 0 0 0 0 -1 -1 0 0 1 0 0 0 0 0 0 0 
1 0 0 0 2 0 0 0 0 0 0 0 0 0 0 0 3 0 0 -1 -1 0 0 0 -1 4 0 0 0 6 0 7 -1 0 0 0 0 0 0 0 0 8 0 0 0 5 0 0 0 0 0 0 0 0 0 0 0 9 -1 10 -1 0 0 -1 
0 0 0 0 0 0 3 -1 0 2 0 0 0 1 0 -1 0 0 0 0 5 -1 0 0 0 0 0 0 0 0 0 4 0 0 -1 0 -1 0 0 0 -1 0 0 0 0 8 0 9 6 0 7 0 0 0 0 0 0 0 0 0 0 0 -1 10 
-1 0 0 -1 0 0 0 10 0 0 0 0 9 0 0 0 0 8 0 0 0 7 -1 6 1 0 0 0 0 0 0 0 0 0 0 0 0 -1 0 0 3 0 0 -1 2 -1 0 0 0 -1 0 0 0 0 0 5 0 0 0 0 4 0 0 0 
0 0 0 0 4 0 0 -1 0 3 0 0 0 0 0 5 0 0 -1 0 0 0 0 0 0 2 0 6 0 0 0 -1 0 0 0 -1 -1 -1 7 0 0 0 0 1 0 0 0 0 9 0 0 0 0 0 0 0 0 0 0 10 -1 8 0 0 
4 0 0 0 0 -1 0 0 0 0 0 0 0 0 0 5 -1 0 3 0 -1 0 0 0 0 2 0 0 -1 6 0 0 0 0 0 0 0 0 1 0 0 0 0 0 -1 0 0 0 0 0 0 0 7 0 -1 -1 0 8 0 9 0 0 0 10 
2 0 0 0 0 0 0 0 0 0 0 1 0 0 0 3 0 0 -1 -1 4 0 5 0 0 9 -1 10 -1 0 0 0 8 0 0 0 0 -1 -1 0 0 0 0 0 0 0 0 6 0 0 0 0 0 0 7 0 0 0 0 -1 0 0 0 0 
0 0 0 4 0 0 0 0 3 -1 0 0 0 0 0 0 0 -1 0 5 0 0 0 0 0 0 2 0 0 0 1 0 -1 0 0 -1 0 6 0 0 10 0 9 0 0 0 0 0 -1 0 0 0 -1 0 0 0 -1 0 0 0 8 0 7 0 
0 0 -1 5 0 -1 0 0 0 0 -1 0 0 0 0 0 0 4 0 0 -1 6 0 0 0 0 0 0 3 0 0 0 0 0 -1 0 0 0 0 7 0 0 2 0 -1 -1 0 0 0 0 0 0 0 1 0 8 10 0 0 0 9 0 0 0 
0 0 0 0 0 0 0 1 2 0 0 -1 0 0 6 0 0 0 0 0 0 7 0 0 0 -1 -1 0 0 0 0 0 0 -1 0 0 0 5 0 8 3 -1 4 0 0 0 0 0 0 0 0 -1 0 0 -1 0 10 0 0 0 9 0 0 0 
0 2 0 0 0 3 0 0 0 0 0 0 0 0 1 0 0 5 0 0 0 0 0 4 0 -1 0 0 0 0 0 0 0 -1 0 0 0 0 -1 -1 6 0 -1 0 0 0 8 0 0 0 0 0 -1 0 0 0 7 0 0 -1 10 0 9 0 
0 0 0 0 0 0 0 -1 0 0 -1 -1 8 0 0 -1 0 7 0 6 0 -1 0 0 0 0 0 0 0 0 9 0 0 0 -1 0 0 5 0 10 0 0 0 0 4 0 0 -1 0 0 0 3 0 0 0 0 1 0 0 0 2 0 0 0 
0 0 5 0 0 0 6 -1 0 4 0 0 0 3 0 0 0 0 0 0 0 0 7 0 0 2 0 0 0 1 0 -1 -1 0 0 -1 8 0 0 0 -1 0 0 0 0 0 0 0 0 0 9 0 0 0 0 0 0 0 0 -1 0 0 -1 10 
4 0 0 0 0 -1 0 0 0 0 0 0 0 0 0 5 3 0 0 0 -1 0 0 0 0 0 0 2 0 0 0 0 -1 -1 1 0 0 0 0 0 0 0 0 6 0 0 0 0 7 0 8 0 0 0 0 -1 -1 0 0 -1 0 9 0 10 
0 0 0 8 0 0 0 0 9 0 0 0 0 0 0 0 0 0 0 0 -1 0 0 -1 0 0 0 -1 10 0 0 -1 0 -1 0 6 0 0 0 0 0 0 0 0 4 0 7 0 0 5 -1 -1 0 0 0 3 1 0 0 0 2 0 0 0 
0 0 0 0 0 0 0 3 2 -1 0 0 0 0 0 0 0 -1 0 4 0 0 0 5 0 0 0 0 0 0 1 0 0 9 0 8 -1 0 0 0 0 0 0 0 7 0 0 0 0 -1 0 0 0 -1 0 6 10 -1 0 0 0 -1 0 0 
0 0 0 0 0 0 0 -1 0 2 0 0 0 1 0 0 10 -1 -1 -1 0 0 3 0 0 0 0 -1 0 0 0 0 0 0 9 0 7 0 0 0 0 8 0 0 0 0 0 4 0 0 -1 0 0 0 5 0 0 0 -1 6 0 0 0 0 
0 0 0 0 -1 -1 0 0 0 0 -1 0 0 0 3 0 0 0 0 2 0 0 0 0 4 0 0 0 0 0 0 0 0 0 0 6 0 -1 -1 1 5 0 0 -1 0 0 7 0 0 0 0 10 -1 0 0 0 9 0 0 0 8 0 0 0 
0 0 0 0 0 0 0 0 3 -1 4 0 -1 0 5 0 0 0 0 2 0 0 0 0 0 0 0 -1 0 0 1 0 0 -1 0 0 -1 10 0 0 0 0 7 0 0 -1 0 0 0 0 0 0 0 9 0 0 8 0 -1 0 6 0 0 0 
-1 -1 0 0 0 0 6 0 0 8 0 7 0 5 0 0 0 0 0 0 -1 0 0 0 0 0 -1 0 0 3 0 4 9 0 0 0 0 0 0 0 0 0 0 10 -1 0 0 0 0 0 0 0 0 -1 -1 0 0 0 0 1 0 0 0 2 
5 0 0 0 0 0 0 0 0 0 0 0 -1 -1 0 0 4 0 -1 -1 0 0 6 0 0 0 0 3 0 2 0 0 1 0 0 0 0 0 0 0 0 0 0 10 -1 0 0 7 0 0 0 0 0 0 8 0 0 0 -1 -1 0 9 0 0 
2 0 0 0 3 0 0 0 0 -1 -1 0 0 -1 0 4 0 0 1 0 6 -1 0 0 0 0 0 0 0 0 0 5 0 0 0 0 7 0 0 0 0 9 -1 10 -1 -1 0 0 0 0 0 0 8 0 0 0 0 0 0 0 0 0 0 0 
0 0 0 0 0 5 0 0 3 0 4 0 0 0 0 0 -1 0 0 -1 0 -1 0 7 0 0 0 -1 6 0 0 0 0 2 0 0 0 1 0 0 0 0 -1 0 0 0 0 0 0 9 0 0 -1 0 0 0 0 0 0 0 10 -1 8 0 
0 0 8 0 0 0 7 0 0 9 0 0 -1 -1 0 0 -1 -1 10 0 0 0 0 0 0 0 0 3 0 0 0 0 2 0 0 0 0 -1 0 0 0 0 0 0 0 -1 0 6 0 -1 0 0 0 0 4 0 0 1 0 0 0 5 0 0 
0 0 0 0 9 0 0 0 0 3 0 0 0 0 -1 0 0 0 -1 0 2 0 10 0 0 0 0 0 -1 0 0 1 8 0 7 0 0 0 4 0 0 0 0 -1 -1 5 0 0 6 0 0 -1 0 0 0 0 0 0 0 0 0 -1 0 0 
-1 0 6 -1 10 0 0 0 0 0 0 0 0 7 0 9 5 0 0 0 -1 0 0 -1 -1 -1 0 4 0 0 0 8 3 0 0 -1 0 0 0 0 0 0 0 0 0 0 0 1 0 0 2 0 0 0 0 0 0 0 0 0 0 0 0 0 
0 0 -1 -1 0 5 0 6 0 0 4 0 0 0 0 0 0 0 0 3 0 0 0 0 0 0 0 0 0 0 2 0 0 1 0 0 0 0 0 7 10 -1 0 0 -1 0 8 0 0 0 0 0 0 0 -1 0 -1 -1 9 0 0 0 0 0 
0 4 -1 0 0 0 0 7 0 0 5 0 6 0 0 0 0 0 0 0 0 -1 0 0 0 0 0 0 0 -1 0 0 0 0 0 0 0 -1 0 8 3 0 10 0 9 0 0 0 0 0 -1 0 0 0 0 -1 2 0 0 0 1 0 0 -1 
0 0 0 0 0 0 0 1 2 0 0 0 0 0 0 0 0 0 0 4 -1 0 0 3 5 -1 0 0 0 0 9 0 0 0 0 0 0 -1 0 0 -1 0 0 0 0 0 0 0 0 0 0 -1 -1 10 -1 8 6 0 0 0 7 0 0 0 
0 2 0 0 0 3 0 0 0 0 1 0 0 0 0 0 -1 -1 0 4 0 0 -1 10 0 0 0 0 0 0 0 0 0 0 0 9 0 0 0 8 0 0 0 -1 -1 0 0 0 -1 5 0 0 0 7 0 0 -1 0 0 0 0 0 6 0 
0 0 0 3 0 0 0 2 4 0 -1 0 0 -1 0 0 0 0 0 5 0 -1 0 1 0 0 0 0 6 -1 10 -1 0 7 0 0 0 8 0 -1 0 0 0 0 0 0 0 0 0 0 0 0 0 0 -1 0 9 0 0 0 0 0 0 0 
0 0 0 2 0 0 0 1 3 0 0 -1 10 0 0 0 -1 0 0 0 0 0 0 0 -1 0 0 0 -1 0 4 0 0 0 0 0 -1 0 -1 0 6 0 0 0 5 0 9 0 0 0 0 0 0 0 0 0 -1 0 7 0 0 0 8 0 
0 0 0 4 -1 5 0 0 0 0 0 0 0 0 6 0 0 3 0 0 0 0 0 0 0 0 0 0 8 0 7 0 0 0 0 0 0 0 -1 -1 0 0 2 0 -1 0 0 0 0 -1 0 10 -1 0 0 0 1 -1 0 0 9 0 0 0 
-1 0 0 0 7 0 0 0 0 0 0 8 -1 0 0 0 0 0 0 0 0 0 6 0 -1 0 0 -1 0 0 0 0 2 0 0 0 1 -1 0 0 0 0 -1 0 0 9 0 0 3 0 10 0 0 0 5 0 0 0 0 4 0 -1 0 0 
6 0 0 0 5 0 0 0 0 0 0 -1 0 0 0 4 0 0 0 -1 3 0 0 0 0 0 0 2 0 0 0 0 7 0 0 0 0 0 1 -1 0 0 0 0 0 0 0 9 0 0 8 0 -1 0 0 0 0 0 0 0 -1 10 -1 -1 
0 0 0 3 0 0 0 0 2 0 0 0 1 0 0 0 0 0 0 -1 -1 4 0 -1 0 0 0 0 5 0 0 -1 0 0 0 6 -1 8 0 0 0 0 0 0 -1 0 0 0 0 0 0 0 0 7 0 9 0 0 0 -1 10 0 0 0 
0 0 10 -1 0 0 0 0 0 9 0 0 0 -1 0 8 0 0 2 0 0 0 0 0 0 1 0 0 0 0 0 7 0 0 0 -1 0 0 0 0 0 0 0 0 0 3 0 0 4 -1 -1 0 5 0 6 0 0 0 0 0 -1 0 0 -1 
-1 0 9 0 0 0 0 0 0 0 0 0 -1 10 0 0 8 0 0 0 0 0 0 0 0 2 -1 -1 -1 0 0 1 0 0 0 0 0 0 0 0 0 -1 0 3 0 0 0 0 7 0 0 0 6 0 4 0 0 0 0 0 -1 5 0 0 
-1 0 7 0 -1 0 0 0 0 0 0 0 0 0 0 0 8 0 0 -1 0 0 0 -1 0 0 0 6 0 5 0 0 0 0 3 0 0 0 4 0 0 0 0 2 0 0 0 1 0 0 9 -1 0 0 0 -1 0 0 0 0 0 -1 0 10 
0 0 2 0 0 0 0 0 0 1 0 0 0 0 0 0 0 0 3 0 0 -1 10 0 0 4 -1 7 0 0 -1 0 0 0 0 0 0 0 0 0 0 5 0 0 0 8 0 0 -1 0 0 0 0 0 9 0 -1 -1 0 6 0 0 0 -1 
2 0 0 0 0 0 0 0 0 -1 0 4 0 0 0 3 0 0 0 0 5 0 6 0 -1 0 0 0 0 0 0 0 0 0 -1 0 1 -1 7 -1 0 0 0 0 0 0 0 10 0 0 0 0 0 0 0 0 0 8 0 9 -1 0 0 -1 
0 0 -1 0 0 0 0 -1 5 0 0 0 0 0 7 -1 0 6 0 8 0 -1 0 0 0 0 4 0 0 0 0 0 -1 -1 0 0 0 0 0 0 2 0 0 0 3 0 0 0 0 0 0 1 0 0 0 0 10 0 0 0 9 0 0 -1 
-1 0 0 0 0 -1 0 10 -1 0 9 0 0 0 0 -1 0 8 -1 7 0 0 0 6 0 0 0 0 0 -1 0 0 0 0 0 0 0 -1 0 0 0 0 0 0 5 0 0 0 0 0 0 4 0 0 0 3 1 0 0 0 2 0 0 0 
0 2 0 0 0 3 0 0 0 0 1 0 5 0 -1 0 -1 6 0 0 -1 0 0 4 0 0 10 0 0 0 0 0 0 7 0 0 0 0 0 9 0 0 0 0 -1 -1 0 0 0 0 0 0 0 8 0 0 0 0 -1 0 0 0 0 -1 
5 0 0 0 0 0 6 -1 0 0 0 4 0 0 0 0 0 0 0 0 0 0 0 0 0 0 0 0 0 0 0 7 -1 0 3 0 0 -1 -1 0 0 0 0 2 0 -1 0 0 1 -1 0 0 0 0 8 0 -1 10 0 0 0 9 0 0 
0 5 0 6 0 0 -1 10 0 0 0 0 7 0 0 0 0 -1 0 0 0 8 0 9 4 -1 0 0 0 0 0 0 0 0 0 0 0 0 0 1 0 0 2 0 0 0 0 0 0 0 0 3 0 -1 -1 0 -1 0 0 -1 0 0 0 0 
0 0 0 0 0 0 7 0 0 -1 -1 0 0 0 -1 0 6 0 -1 0 0 0 8 0 0 0 0 4 0 9 0 -1 5 0 0 0 0 0 0 -1 0 3 0 0 0 0 0 0 0 0 10 0 0 0 0 0 -1 2 0 0 0 1 0 0 
-1 0 9 0 8 0 0 0 -1 0 0 0 0 0 0 0 10 0 -1 -1 0 0 0 0 0 0 0 0 0 0 -1 7 2 0 0 0 1 0 0 0 -1 0 0 3 0 0 0 0 0 0 4 0 -1 0 0 0 0 0 0 0 0 5 0 6 
1 0 0 0 0 0 0 0 0 0 0 3 0 0 0 2 4 0 0 0 0 0 9 0 -1 6 0 5 0 0 0 0 0 0 0 0 0 -1 -1 0 0 0 -1 -1 0 -1 0 0 0 0 0 0 8 0 0 0 0 0 0 7 0 0 -1 10 
0 0 0 0 8 0 0 0 0 7 0 6 0 0 -1 0 0 0 0 0 0 0 -1 0 0 4 0 0 0 0 0 0 0 0 3 0 0 0 5 0 -1 -1 0 -1 0 0 0 9 1 -1 0 0 2 0 0 0 0 0 0 0 0 0 -1 10 
0 0 0 0 0 0 9 0 0 8 0 0 0 0 -1 0 -1 0 -1 0 0 -1 10 0 -1 0 0 7 0 0 0 0 0 0 5 0 0 0 6 0 0 4 -1 2 0 0 0 0 0 0 -1 0 0 0 1 0 0 0 0 0 0 3 0 0 
0 0 0 0 1 -1 0 0 0 0 -1 0 0 0 0 9 2 0 10 0 -1 -1 0 0 0 0 0 3 0 -1 0 0 4 0 0 0 0 0 0 0 0 -1 0 0 0 7 0 0 0 0 0 0 0 0 0 0 0 5 0 6 -1 0 0 8 
0 0 0 0 0 0 6 0 0 0 -1 7 0 -1 0 0 0 0 0 0 0 0 5 0 0 -1 0 -1 0 0 -1 0 0 0 0 0 0 0 4 0 0 0 -1 3 0 0 0 2 0 0 0 -1 1 0 0 0 0 8 0 9 0 0 0 10 
6 0 0 0 -1 0 0 -1 0 0 0 0 0 0 0 0 0 -1 0 0 -1 0 0 0 0 5 0 0 0 0 0 0 7 0 4 0 0 0 3 0 0 0 0 -1 0 2 0 0 0 -1 1 0 0 -1 10 0 0 8 0 0 0 9 0 0 
0 5 -1 0 0 -1 0 0 0 0 0 0 0 0 6 0 0 0 0 -1 0 0 0 0 4 0 3 0 0 -1 0 0 -1 0 0 -1 0 2 0 7 1 0 0 0 0 0 0 0 0 9 0 0 0 10 -1 0 0 0 0 0 0 0 8 0 
0 0 0 0 9 0 0 -1 0 0 -1 0 0 -1 0 10 0 0 0 0 0 0 7 0 0 0 0 5 0 0 -1 0 8 0 0 0 6 0 0 0 -1 -1 0 4 0 0 0 -1 0 0 1 0 0 0 3 0 0 0 0 0 0 2 0 0 
0 0 3 0 0 0 2 0 0 0 0 -1 -1 1 0 0 4 0 0 0 0 0 0 0 0 0 0 5 0 10 -1 0 0 0 9 0 0 -1 -1 0 0 8 0 0 0 -1 -1 0 0 0 0 0 7 0 6 0 0 0 0 0 0 0 0 0 
0 0 0 0 -1 0 5 0 0 0 0 8 -1 0 0 0 0 0 -1 0 6 -1 0 0 0 7 0 0 0 0 0 0 0 0 2 0 0 0 3 0 -1 0 0 0 0 1 0 0 9 0 10 0 0 -1 0 0 0 0 0 0 0 -1 0 4 
2 0 0 0 1 0 7 0 0 0 -1 6 0 0 -1 0 3 0 -1 0 0 0 5 0 0 0 0 4 0 0 0 0 0 0 0 0 0 0 -1 0 0 0 0 0 0 8 0 0 0 0 0 0 9 0 0 0 0 0 0 0 -1 -1 -1 10 
0 0 0 0 0 0 0 0 6 0 0 -1 0 0 7 0 0 5 0 -1 0 8 0 0 0 0 10 0 -1 0 -1 -1 -1 0 -1 0 0 0 0 9 0 0 0 0 0 0 0 0 0 0 0 4 0 0 0 3 1 0 0 0 2 0 0 0 
0 6 -1 0 0 7 0 0 0 0 -1 0 -1 0 0 0 0 0 0 0 0 0 0 0 5 0 0 0 4 -1 3 0 -1 0 0 2 0 0 0 8 1 0 -1 0 0 0 0 0 0 0 0 0 0 0 0 0 0 0 10 -1 0 0 9 0 
0 0 0 0 0 0 0 0 0 0 4 0 0 0 0 0 0 0 0 0 -1 0 0 0 2 0 0 0 3 0 -1 0 0 0 0 1 0 0 0 0 -1 0 7 -1 6 0 5 -1 0 0 0 0 0 -1 -1 10 8 0 0 0 9 0 0 0 
0 0 0 0 0 0 0 0 0 0 1 0 0 0 0 0 0 3 0 2 0 8 0 0 0 0 0 -1 0 0 7 0 0 4 -1 10 0 9 0 -1 0 0 -1 -1 0 0 0 0 0 5 0 6 -1 0 0 0 -1 0 0 0 0 0 0 0 
0 0 0 0 0 0 4 0 0 3 0 0 0 2 0 0 1 0 0 0 0 0 0 0 0 9 0 0 0 -1 0 5 0 0 0 -1 8 0 0 0 0 0 0 -1 -1 0 0 6 0 0 0 0 10 -1 7 0 0 0 0 0 -1 -1 0 0 
0 7 0 -1 -1 0 0 -1 0 0 0 0 6 0 5 0 0 0 0 0 0 0 0 0 0 0 3 -1 4 0 0 0 -1 8 0 0 0 2 0 0 0 0 -1 0 0 -1 1 0 0 0 0 0 0 0 0 9 10 0 0 0 0 0 0 0 
0 2 0 0 -1 0 0 -1 0 0 1 0 -1 0 5 0 0 0 0 0 -1 4 0 0 0 0 0 0 3 0 0 0 0 0 0 7 0 0 0 6 0 0 -1 -1 10 -1 0 0 0 0 0 8 0 0 0 0 0 0 0 0 0 0 9 0 
-1 0 0 0 0 0 0 0 0 8 -1 10 0 0 0 9 0 0 0 0 0 0 0 0 0 0 0 2 -1 1 0 0 7 0 -1 0 0 0 0 0 0 0 0 0 -1 3 0 0 0 0 6 0 0 0 -1 0 -1 0 0 5 0 4 0 0 
-1 0 0 0 0 0 4 -1 0 0 0 0 0 0 0 0 0 0 -1 0 0 0 3 0 -1 0 0 2 0 0 0 0 0 0 5 -1 1 0 0 0 0 -1 -1 0 0 0 0 10 6 0 7 0 0 0 9 0 0 0 0 0 0 8 0 0 
0 0 0 1 0 0 0 3 2 0 0 0 0 -1 0 0 -1 0 0 0 0 4 0 0 0 0 6 0 -1 0 0 0 0 -1 0 0 0 7 -1 10 0 0 0 -1 0 0 0 0 0 0 0 0 0 8 0 9 5 0 0 0 -1 0 0 0 
0 0 0 0 0 2 0 0 0 0 1 0 0 0 3 0 0 0 0 0 0 0 0 6 0 0 0 0 0 0 0 0 0 0 -1 4 0 0 0 0 0 0 10 -1 -1 0 5 0 0 0 0 0 0 8 0 7 -1 -1 9 0 -1 0 0 -1 
0 0 9 0 0 -1 10 0 0 0 0 0 0 0 0 0 0 0 0 0 8 0 0 -1 0 2 0 0 0 0 0 7 -1 0 0 0 1 0 -1 0 0 0 0 3 0 0 -1 0 4 -1 0 0 5 0 0 0 0 0 0 0 0 -1 0 6 
-1 0 0 0 0 0 6 0 0 0 0 0 -1 0 0 0 0 0 9 0 10 -1 0 0 0 0 -1 0 0 0 0 0 0 0 8 0 0 0 5 0 0 0 0 -1 0 4 0 0 0 0 -1 0 0 0 1 0 0 7 -1 2 0 0 0 3 
0 0 0 0 0 0 0 0 1 -1 0 0 2 0 0 0 0 0 0 4 0 -1 0 0 0 0 0 0 0 0 5 0 0 3 -1 6 0 0 0 0 -1 0 0 0 -1 0 0 -1 -1 7 0 0 0 8 0 0 10 0 0 0 9 0 0 0 
-1 0 0 0 0 0 0 0 0 9 0 6 0 0 0 8 0 0 0 0 -1 -1 7 0 -1 10 -1 0 0 0 0 0 0 0 0 0 1 0 0 -1 0 0 0 2 0 -1 0 0 0 0 3 0 0 0 0 0 0 4 0 0 0 0 0 5 
0 0 3 -1 4 0 0 0 0 0 0 0 0 0 0 0 -1 0 0 0 0 0 0 0 0 1 -1 0 0 0 0 5 0 0 2 0 -1 0 0 0 0 0 0 7 -1 6 -1 10 8 0 0 0 0 0 0 0 0 0 0 0 0 9 0 -1 
0 0 0 0 0 0 0 0 0 0 0 0 0 0 0 0 -1 0 5 -1 4 0 0 0 0 3 0 0 0 -1 -1 0 0 0 2 0 0 0 1 0 0 0 0 7 0 0 0 6 0 0 8 0 9 0 0 -1 0 0 0 0 -1 -1 0 10 
1 0 0 -1 10 0 0 0 0 0 0 -1 0 0 0 0 0 0 0 -1 9 -1 -1 -1 0 0 0 0 0 7 0 0 2 0 0 0 0 0 0 0 0 3 0 8 0 0 0 0 0 0 0 0 0 0 -1 0 0 4 0 5 0 0 0 6 
9 0 0 0 10 -1 0 0 0 0 0 0 0 7 0 6 -1 -1 8 0 0 0 0 0 0 0 0 -1 0 5 0 0 0 -1 0 0 0 0 0 0 0 0 0 -1 0 1 0 4 0 0 2 -1 3 0 0 0 0 0 0 0 0 0 0 0 
0 0 4 0 -1 0 0 -1 0 3 0 0 0 0 0 0 0 0 0 0 5 -1 6 0 0 0 0 2 0 0 0 0 0 0 0 -1 -1 0 1 0 0 0 0 0 0 -1 0 7 0 0 0 0 8 0 0 -1 0 9 0 0 0 0 0 10 
-1 0 0 4 0 0 0 5 0 0 0 0 0 -1 0 0 0 0 0 -1 0 0 0 6 2 0 0 0 0 0 0 0 0 0 0 1 0 3 0 0 9 0 0 0 0 0 7 0 0 0 -1 0 0 -1 0 0 -1 0 10 -1 0 0 8 0 
0 0 0 2 0 0 0 1 0 0 0 0 0 0 0 0 0 0 0 0 0 0 0 3 0 0 -1 0 4 0 0 0 0 5 -1 -1 0 9 -1 10 0 0 6 0 0 0 8 0 0 0 0 0 -1 -1 0 0 0 0 0 0 0 0 7 -1 
0 0 0 0 0 -1 -1 -1 0 0 1 0 2 -1 0 0 0 0 0 0 0 4 0 5 0 0 3 0 0 0 0 0 0 0 0 0 0 0 0 0 7 0 6 0 8 0 0 0 0 -1 0 0 -1 0 0 0 0 0 0 -1 10 0 9 0 
0 0 0 0 0 1 0 0 0 0 2 0 0 0 3 0 0 10 -1 4 0 0 0 0 0 0 9 0 0 0 5 0 -1 -1 0 -1 -1 6 0 0 8 0 0 0 7 0 0 0 0 -1 0 0 0 0 0 0 0 0 0 -1 0 0 0 0 
0 0 0 0 0 0 0 2 1 -1 -1 0 3 0 0 0 0 5 -1 0 0 0 0 0 0 0 -1 0 0 0 4 0 0 0 0 0 0 0 0 0 6 0 0 0 7 0 0 0 0 0 0 0 0 9 -1 8 0 0 10 -1 -1 0 0 0 
0 0 0 7 -1 -1 0 0 6 0 -1 0 0 -1 0 0 0 0 -1 0 0 0 0 0 5 0 4 0 0 0 -1 0 0 0 0 0 0 3 0 8 1 0 0 0 2 0 0 0 0 0 0 0 0 0 0 0 0 0 9 0 0 0 10 -1 
0 0 0 0 0 0 0 0 0 0 0 0 0 6 -1 5 7 0 -1 0 3 0 0 0 0 2 0 0 0 0 0 0 0 0 0 0 0 0 4 0 0 0 -1 0 0 0 0 1 -1 0 8 0 0 0 0 -1 -1 0 0 -1 0 9 0 10 
0 0 0 0 0 0 0 0 0 0 0 0 0 0 -1 0 0 0 0 3 0 4 0 5 0 0 0 -1 0 0 0 0 -1 6 0 2 0 0 0 1 -1 0 -1 0 0 -1 0 0 -1 0 0 7 0 8 0 9 10 0 0 0 0 0 0 0 
0 0 0 0 4 -1 5 0 0 0 0 3 0 0 0 0 2 0 0 0 6 0 -1 0 0 0 0 1 0 0 0 0 0 0 0 0 0 0 0 0 0 9 -1 0 0 8 -1 0 0 0 10 0 -1 0 7 0 0 0 0 0 -1 0 0 -1 
0 0 2 0 0 0 0 0 0 -1 0 4 -1 1 0 0 3 0 0 0 0 0 5 0 0 0 0 0 -1 6 0 0 0 -1 0 0 0 0 10 0 0 0 0 0 0 -1 -1 0 7 0 8 0 0 0 0 0 0 0 0 -1 0 9 0 0 
-1 0 0 2 0 0 0 3 -1 0 1 0 4 0 0 0 0 0 -1 0 0 0 0 -1 0 0 0 0 0 0 0 -1 0 5 0 0 0 6 0 0 8 0 0 0 7 -1 0 0 0 9 0 -1 0 0 0 10 0 0 0 0 0 0 0 0 
0 0 0 0 0 0 0 0 0 10 -1 0 0 0 0 0 0 0 3 0 0 0 4 0 0 -1 0 5 0 0 0 0 2 -1 0 0 6 0 -1 0 0 -1 0 7 0 0 0 0 0 -1 0 0 0 0 9 0 0 1 -1 8 0 0 0 0 
0 0 2 -1 0 0 0 0 0 1 0 0 0 -1 0 0 0 0 0 0 3 0 0 -1 0 0 0 0 0 5 0 0 10 0 4 0 0 0 6 0 0 0 -1 -1 0 7 0 0 0 -1 9 0 -1 0 0 0 0 0 0 0 0 0 0 8 
0 0 0 7 0 0 0 -1 0 0 0 0 6 0 0 0 0 3 0 0 0 0 0 0 0 0 2 -1 4 0 5 0 0 0 0 -1 -1 0 0 8 0 0 0 0 1 -1 0 0 0 0 0 0 0 0 0 -1 0 0 9 0 0 0 10 -1 
6 0 0 0 0 0 7 0 0 0 0 0 0 8 0 0 0 -1 -1 0 9 0 0 0 0 4 0 0 0 0 0 10 5 0 0 0 -1 0 0 -1 0 0 0 0 -1 0 0 -1 0 0 0 0 3 0 0 -1 0 0 0 2 0 0 0 1 
0 0 0 0 0 1 0 10 0 0 2 0 0 -1 0 -1 0 0 0 0 0 -1 0 -1 0 0 0 0 0 0 9 0 0 0 -1 0 0 0 0 0 0 0 5 0 4 -1 3 0 0 6 0 0 0 0 0 8 0 0 -1 0 7 0 0 0 
0 0 -1 0 0 0 0 0 0 0 -1 0 5 0 -1 0 0 3 0 4 -1 6 0 0 0 0 0 0 0 0 0 0 -1 2 0 0 0 0 0 7 0 0 0 0 -1 0 0 0 0 1 -1 9 0 0 0 0 10 0 0 0 0 0 8 0 
0 0 6 0 -1 0 4 0 0 0 0 0 -1 0 0 0 0 0 -1 0 5 0 0 0 0 7 0 0 0 0 0 0 0 -1 0 0 2 0 3 0 0 0 -1 1 0 0 -1 -1 0 0 10 0 0 0 9 0 0 8 0 0 0 0 0 0 
-1 10 0 0 0 0 0 0 0 0 0 0 2 0 0 0 0 0 0 1 0 3 0 9 -1 0 4 0 0 0 0 0 0 0 0 0 0 0 0 0 0 -1 6 0 0 -1 8 0 0 -1 0 0 0 -1 0 0 0 0 5 -1 0 0 7 0 
0 0 -1 0 4 0 0 0 0 5 0 0 0 3 0 0 0 0 0 0 0 0 0 0 0 0 0 6 -1 2 0 0 0 0 0 -1 0 0 0 0 0 7 0 -1 0 1 0 10 0 0 -1 0 0 -1 0 0 -1 8 0 0 0 0 0 9 
0 1 -1 2 0 0 0 3 0 -1 0 0 -1 0 0 0 0 0 0 -1 0 4 0 0 0 0 10 -1 0 0 0 0 0 0 0 0 0 0 0 5 9 0 0 0 0 0 6 0 0 8 0 0 0 0 -1 0 0 0 -1 0 0 0 7 0 
0 0 0 0 0 0 0 1 2 0 0 0 3 0 0 -1 0 6 -1 -1 0 0 0 4 0 0 0 0 0 0 5 0 0 7 0 0 0 0 0 0 10 0 0 0 -1 0 8 -1 0 0 -1 0 0 -1 0 0 0 0 0 0 0 0 9 0 
-1 0 0 0 0 0 0 4 3 0 0 0 0 0 -1 0 0 0 0 0 0 0 -1 0 2 0 0 0 0 0 5 0 0 0 0 1 0 0 0 -1 10 -1 0 0 6 0 0 0 0 9 0 8 0 0 0 7 0 0 -1 0 0 -1 0 0 
0 0 0 5 0 6 0 -1 0 0 0 0 0 0 0 -1 0 4 -1 0 0 0 0 7 0 0 3 0 -1 0 0 0 -1 0 0 0 0 2 0 0 0 0 -1 -1 0 0 0 0 0 1 0 0 0 8 0 0 10 0 0 0 0 0 9 0 
